original	new
Gaymuthafuckinwhore	G*ymuth*fuckinwhore
gaymuthafuckinwhore	g*ymuth*fuckinwhore
Goddamnmuthafucker	Godd*mnmuth*fucker
goddamnmuthafucker	godd*mnmuth*fucker
mattressprincess	m*ttressprincess
Mattressprincess	M*ttressprincess
spaghettibender	sp*ghettibender
spaghettinigger	sp*ghettinigger
Spaghettibender	Sp*ghettibender
devilworshipper	devilworshipper
niggardliness's	nigg*rdliness's
Spaghettinigger	Sp*ghettinigger
Devilworshipper	Devilworshipper
Niggardliness's	Nigg*rdliness's
Motherfuckings	Motherfuckings
Poorwhitetrash	Poorwhitetr*sh
spankthemonkey	sp*nkthemonkey
smackthemonkey	sm*ckthemonkey
purinapricness	purin*pricness
Motherlovebone	Motherlovebone
Luckycammeltoe	Luckyc*mmeltoe
Purinapricness	Purin*pricness
motherfuckings	motherfuckings
motherlovebone	motherlovebone
Spankthemonkey	Sp*nkthemonkey
poorwhitetrash	poorwhitetr*sh
Smackthemonkey	Sm*ckthemonkey
luckycammeltoe	luckyc*mmeltoe
Alligatorbait	Allig*torb*it
jacktheripper	j*cktheripper
Tongethruster	Tongethruster
Carpetmuncher	C*rpetmuncher
shitforbrains	shitforbr*ins
fingerfucking	fingerfucking
Motherfucking	Motherfucking
pooperscooper	pooperscooper
Masterblaster	M*sterbl*ster
dickforbrains	dickforbr*ins
Jacktheripper	J*cktheripper
Fingerfuckers	Fingerfuckers
fingerfuckers	fingerfuckers
Pooperscooper	Pooperscooper
Fingerfucking	Fingerfucking
niggardliness	nigg*rdliness
carpetmuncher	c*rpetmuncher
virginbreaker	virginbre*ker
Shitforbrains	Shitforbr*ins
pearlnecklace	pe*rlneckl*ce
Virginbreaker	Virginbre*ker
Assassination	Ass*ssin*tion
shitoutofluck	shitoutofluck
Niggardliness	Nigg*rdliness
assassination	*ss*ssin*tion
tongethruster	tongethruster
Mothafuckings	Moth*fuckings
mothafuckings	moth*fuckings
Shitoutofluck	Shitoutofluck
masterblaster	m*sterbl*ster
alligatorbait	*llig*torb*it
Dickforbrains	Dickforbr*ins
motherfucking	motherfucking
Pearlnecklace	Pe*rlneckl*ce
Pussypounder	Pussypounder
Heterosexual	Heterosexu*l
transvestite	tr*nsvestite
freakyfucker	fre*kyfucker
Conservative	Conserv*tive
masturbating	m*sturb*ting
Fingerfucked	Fingerfucked
motherfucker	motherfucker
Transvestite	Tr*nsvestite
Pornprincess	Pornprincess
pussypounder	pussypounder
pornprincess	pornprincess
Cherrypopper	Cherrypopper
motherfucked	motherfucked
Mothafucking	Moth*fucking
grostulation	grostul*tion
Goldenshower	Goldenshower
fingerfucker	fingerfucker
Fuckingbitch	Fuckingbitch
Titbitnipply	Titbitnipply
crotchmonkey	crotchmonkey
tunneloflove	tunneloflove
Timbernigger	Timbernigger
Spermhearder	Spermhe*rder
Motherfuckin	Motherfuckin
crotchjockey	crotchjockey
Trailertrash	Tr*ilertr*sh
Motherfucker	Motherfucker
Motherfucked	Motherfucked
williewanker	williew*nker
Fingerfucker	Fingerfucker
fingerfucked	fingerfucked
trailertrash	tr*ilertr*sh
Tunneloflove	Tunneloflove
tonguethrust	tonguethrust
motherfuckin	motherfuckin
Masturbating	M*sturb*ting
Crotchmonkey	Crotchmonkey
butt-fuckers	butt-fuckers
mothafucking	moth*fucking
goldenshower	goldenshower
stupidfucker	stupidfucker
Freakyfucker	Fre*kyfucker
Stupidfucker	Stupidfucker
Lezbefriends	Lezbefriends
athletesfoot	*thletesfoot
Williewanker	Williew*nker
timbernigger	timbernigger
spermhearder	spermhe*rder
fuckingbitch	fuckingbitch
Athletesfoot	Athletesfoot
nofuckingway	nofuckingw*y
cherrypopper	cherrypopper
Crotchjockey	Crotchjockey
beatyourmeat	be*tyourme*t
titbitnipply	titbitnipply
heterosexual	heterosexu*l
Butt-fuckers	Butt-fuckers
lezbefriends	lezbefriends
Beatyourmeat	Be*tyourme*t
Nofuckingway	Nofuckingw*y
Tonguethrust	Tonguethrust
Grostulation	Grostul*tion
conservative	conserv*tive
crack-whore	cr*ck-whore
sonofabitch	sonof*bitch
Mothafuckaz	Moth*fuck*z
Shithappens	Shith*ppens
doggiestyle	doggiestyle
Junglebunny	Junglebunny
cuntlicking	cuntlicking
Intercourse	Intercourse
Twobitwhore	Twobitwhore
Fudgepacker	Fudgep*cker
tonguetramp	tonguetr*mp
pussyfucker	pussyfucker
homobangers	homob*ngers
mothafuckin	moth*fuckin
Butt-fucker	Butt-fucker
Doggiestyle	Doggiestyle
mooncricket	mooncricket
Ejaculating	Ej*cul*ting
Fistfucking	Fistfucking
Backdoorman	B*ckdoorm*n
Penetration	Penetr*tion
Pussyfucker	Pussyfucker
executioner	executioner
Crack-whore	Cr*ck-whore
whiskeydick	whiskeydick
Whorefucker	Whorefucker
junglebunny	junglebunny
Fuckinright	Fuckinright
spreadeagle	spre*de*gle
Cunillingus	Cunillingus
Holestuffer	Holestuffer
Buttfuckers	Buttfuckers
ejaculation	ej*cul*tion
Cuntlicking	Cuntlicking
intercourse	intercourse
Fannyfucker	F*nnyfucker
Pussylicker	Pussylicker
porchmonkey	porchmonkey
Beastiality	Be*sti*lity
snatchpatch	sn*tchp*tch
kunnilingus	kunnilingus
Mothafuckin	Moth*fuckin
beastiality	be*sti*lity
molestation	molest*tion
Whitenigger	Whitenigger
Molestation	Molest*tion
cyberslimer	cyberslimer
mothafucker	moth*fucker
Buttmuncher	Buttmuncher
interracial	interr*ci*l
fistfucking	fistfucking
fudgepacker	fudgep*cker
ejaculating	ej*cul*ting
whorefucker	whorefucker
Kunnilingus	Kunnilingus
Spermherder	Spermherder
Cunnilingus	Cunnilingus
Tonguetramp	Tonguetr*mp
slimebucket	slimebucket
cockblocker	cockblocker
Slimebucket	Slimebucket
Snatchpatch	Sn*tchp*tch
Whiskeydick	Whiskeydick
buttmuncher	buttmuncher
Cameljockey	C*meljockey
Dingleberry	Dingleberry
Mastrabator	M*str*b*tor
Glazeddonut	Gl*zeddonut
transsexual	tr*nssexu*l
Cockblocker	Cockblocker
shithappens	shith*ppens
cunnilingus	cunnilingus
pussylicker	pussylicker
palestinian	p*lestini*n
slavedriver	sl*vedriver
Meatbeatter	Me*tbe*tter
Executioner	Executioner
twobitwhore	twobitwhore
Pornography	Pornogr*phy
butt-fucker	butt-fucker
cocksucking	cocksucking
Cocksucking	Cocksucking
Breastlover	Bre*stlover
Ejaculation	Ej*cul*tion
pornography	pornogr*phy
cameljockey	c*meljockey
whitenigger	whitenigger
Jesuschrist	Jesuschrist
Interracial	Interr*ci*l
spermherder	spermherder
jesuschrist	jesuschrist
cunillingus	cunillingus
Mothafucker	Moth*fucker
dingleberry	dingleberry
mothafuckaz	moth*fuck*z
Sonofabitch	Sonof*bitch
Cyberslimer	Cyberslimer
Palestinian	P*lestini*n
skankybitch	sk*nkybitch
barelylegal	b*relyleg*l
mastrabator	m*str*b*tor
Skankywhore	Sk*nkywhore
meatbeatter	me*tbe*tter
Slavedriver	Sl*vedriver
fuckinright	fuckinright
muffindiver	muffindiver
Skankybitch	Sk*nkybitch
Transsexual	Tr*nssexu*l
penetration	penetr*tion
buttfuckers	buttfuckers
backdoorman	b*ckdoorm*n
mothafucked	moth*fucked
breastlover	bre*stlover
fannyfucker	f*nnyfucker
Hillbillies	Hillbillies
assassinate	*ss*ssin*te
Mothafucked	Moth*fucked
Muffindiver	Muffindiver
hillbillies	hillbillies
holestuffer	holestuffer
Barelylegal	B*relyleg*l
Homobangers	Homob*ngers
Porchmonkey	Porchmonkey
glazeddonut	gl*zeddonut
skankywhore	sk*nkywhore
Assassinate	Ass*ssin*te
Mooncricket	Mooncricket
Spreadeagle	Spre*de*gle
fingerfood	fingerfood
fuckmehard	fuckmeh*rd
Deepthroat	Deepthro*t
Mothafucka	Moth*fuck*
Transexual	Tr*nsexu*l
Footaction	Foot*ction
Lovemuscle	Lovemuscle
fingerfuck	fingerfuck
fistfucked	fistfucked
deapthroat	de*pthro*t
bumblefuck	bumblefuck
Motherfuck	Motherfuck
Fuckmehard	Fuckmeh*rd
nastybitch	n*stybitch
footfucker	footfucker
Loverocket	Loverocket
assblaster	*ssbl*ster
Snownigger	Snownigger
fuckinnuts	fuckinnuts
pickaninny	pick*ninny
deepthroat	deepthro*t
protestant	protest*nt
Butchbabes	Butchb*bes
bestiality	besti*lity
assmuncher	*ssmuncher
cuntfucker	cuntfucker
sandnigger	s*ndnigger
masturbate	m*sturb*te
doggystyle	doggystyle
Niggarding	Nigg*rding
Doggystyle	Doggystyle
masterbate	m*sterb*te
Sandnigger	S*ndnigger
Masterbate	M*sterb*te
Mufflikcer	Mufflikcer
Cocksmoker	Cocksmoker
mufflikcer	mufflikcer
footlicker	footlicker
Fourtwenty	Fourtwenty
Pocketpool	Pocketpool
flatulence	fl*tulence
sixtyniner	sixtyniner
Shawtypimp	Sh*wtypimp
shawtypimp	sh*wtypimp
asspuppies	*sspuppies
samckdaddy	s*mckd*ddy
children's	children's
sniggering	sniggering
Flatulence	Fl*tulence
Lovepistol	Lovepistol
Palesimian	P*lesimi*n
pussyeater	pussye*ter
Headlights	He*dlights
Bigbastard	Bigb*st*rd
sleezeball	sleezeb*ll
Fingerfuck	Fingerfuck
greaseball	gre*seb*ll
lovemuscle	lovemuscle
suckmydick	suckmydick
Mickeyfinn	Mickeyfinn
republican	republic*n
dicklicker	dicklicker
Sonofbitch	Sonofbitch
Balllicker	B*lllicker
Propaganda	Prop*g*nd*
Beastality	Be*st*lity
whiskydick	whiskydick
cocksmoker	cocksmoker
gangbanged	g*ngb*nged
Gangbanged	G*ngb*nged
fourtwenty	fourtwenty
Bestiality	Besti*lity
transexual	tr*nsexu*l
propaganda	prop*g*nd*
facefucker	f*cefucker
Fistfucker	Fistfucker
Dicklicker	Dicklicker
kunilingus	kunilingus
Cuntfucker	Cuntfucker
Cocklicker	Cocklicker
pussylover	pussylover
Shitfucker	Shitfucker
cocklicker	cocklicker
Suckmydick	Suckmydick
peckerwood	peckerwood
Niggaracci	Nigg*r*cci
Gangbanger	G*ngb*nger
mothafucka	moth*fuck*
Pussylover	Pussylover
beastality	be*st*lity
footaction	foot*ction
Homosexual	Homosexu*l
Peckerwood	Peckerwood
snownigger	snownigger
nipplering	nipplering
Nastybitch	N*stybitch
Australian	Austr*li*n
gonorrehea	gonorrehe*
pocketpool	pocketpool
Sixtyniner	Sixtyniner
cocksucker	cocksucker
Whitetrash	Whitetr*sh
Footfucker	Footfucker
Facefucker	F*cefucker
Sleezeball	Sleezeb*ll
Cuntsucker	Cuntsucker
loverocket	loverocket
crackwhore	cr*ckwhore
Stupidfuck	Stupidfuck
Cuntlicker	Cuntlicker
stupidfuck	stupidfuck
Gonorrehea	Gonorrehe*
Spermacide	Sperm*cide
cunilingus	cunilingus
Unfuckable	Unfuck*ble
prostitute	prostitute
gangbanger	g*ngb*nger
niggaracci	nigg*r*cci
Fistfucked	Fistfucked
nastywhore	n*stywhore
Children's	Children's
skankbitch	sk*nkbitch
conspiracy	conspir*cy
corruption	corruption
Deapthroat	De*pthro*t
sonofbitch	sonofbitch
Fuckinnuts	Fuckinnuts
Skankbitch	Sk*nkbitch
motherfuck	motherfuck
cuntlicker	cuntlicker
buttfucker	buttfucker
Crackwhore	Cr*ckwhore
clamdigger	cl*mdigger
shithapens	shith*pens
Greaseball	Gre*seb*ll
australian	*ustr*li*n
zipperhead	zipperhe*d
cockcowboy	cockcowboy
piccaninny	picc*ninny
balllicker	b*lllicker
mickeyfinn	mickeyfinn
Assblaster	Assbl*ster
bigbastard	bigb*st*rd
homosexual	homosexu*l
Niggerhole	Niggerhole
Corruption	Corruption
cuntsucker	cuntsucker
Chickslick	Chickslick
Fuckmonkey	Fuckmonkey
fuckfriend	fuckfriend
Pussyeater	Pussye*ter
Protestant	Protest*nt
Prostitute	Prostitute
Whorehouse	Whorehouse
Cocksucked	Cocksucked
whitetrash	whitetr*sh
mastabater	m*st*b*ter
Cunilingus	Cunilingus
niggerhole	niggerhole
cocksucked	cocksucked
Masturbate	M*sturb*te
niggerhead	niggerhe*d
headlights	he*dlights
Buttpirate	Buttpir*te
Republican	Republic*n
Kunilingus	Kunilingus
lovepistol	lovepistol
Nipplering	Nipplering
Conspiracy	Conspir*cy
Piccaninny	Picc*ninny
spermacide	sperm*cide
Niggerhead	Niggerhe*d
Zipperhead	Zipperhe*d
Shithapens	Shith*pens
Sniggering	Sniggering
Fuckfriend	Fuckfriend
Skankwhore	Sk*nkwhore
Clamdigger	Cl*mdigger
Buttfucker	Buttfucker
Mastabater	M*st*b*ter
buttpirate	buttpir*te
fuckmonkey	fuckmonkey
chickslick	chickslick
niggarding	nigg*rding
fistfucker	fistfucker
unfuckable	unfuck*ble
Cocksucker	Cocksucker
Assmuncher	Assmuncher
Bumblefuck	Bumblefuck
Fingerfood	Fingerfood
Cockcowboy	Cockcowboy
shitfucker	shitfucker
ejaculated	ej*cul*ted
Ejaculated	Ej*cul*ted
butchbabes	butchb*bes
skankwhore	sk*nkwhore
Nastywhore	N*stywhore
Asspuppies	Asspuppies
Pickaninny	Pick*ninny
Samckdaddy	S*mckd*ddy
whorehouse	whorehouse
Footlicker	Footlicker
Whiskydick	Whiskydick
palesimian	p*lesimi*n
shortfuck	shortfuck
cocksmith	cocksmith
Assfucker	Assfucker
marijuana	m*riju*n*
butchdike	butchdike
Asslicker	Asslicker
pornflick	pornflick
cockblock	cockblock
Titfucker	Titfucker
cumbubble	cumbubble
Slaughter	Sl*ughter
picaninny	pic*ninny
Sniggered	Sniggered
Rearentry	Re*rentry
Breastjob	Bre*stjob
fuckfreak	fuckfre*k
fatfucker	f*tfucker
titfuckin	titfuckin
disturbed	disturbed
Asscowboy	Asscowboy
cumjockey	cumjockey
ethiopian	ethiopi*n
Marijuana	M*riju*n*
Nigerians	Nigeri*ns
assbagger	*ssb*gger
fornicate	fornic*te
upthebutt	upthebutt
magicwand	m*gicw*nd
Feltching	Feltching
Shitfaced	Shitf*ced
Loadedgun	Lo*dedgun
Penthouse	Penthouse
Sexy-slim	Sexy-slim
Analannie	An*l*nnie
slideitin	slideitin
snigger's	snigger's
Suckmytit	Suckmytit
Buttmunch	Buttmunch
Trisexual	Trisexu*l
explosion	explosion
Assranger	Assr*nger
sweetness	sweetness
Cocklover	Cocklover
Goddamnit	Godd*mnit
Stripclub	Stripclub
Magicwand	M*gicw*nd
pimpjuice	pimpjuice
Crackpipe	Cr*ckpipe
buttstain	buttst*in
Titlicker	Titlicker
Horseshit	Horseshit
bountybar	bountyb*r
pussylips	pussylips
swallower	sw*llower
lovejuice	lovejuice
Suckmyass	Suckmy*ss
Shithouse	Shithouse
Freakfuck	Fre*kfuck
Primetime	Primetime
sniggered	sniggered
Ethiopian	Ethiopi*n
asscowboy	*sscowboy
Buttstain	Buttst*in
execution	execution
rearentry	re*rentry
Asskisser	Asskisser
Ejaculate	Ej*cul*te
Dixiedyke	Dixiedyke
stripclub	stripclub
ejaculate	ej*cul*te
goddammit	godd*mmit
Slutwhore	Slutwhore
hitlerist	hitlerist
Catholics	C*tholics
Moneyshot	Moneyshot
asskisser	*sskisser
skinflute	skinflute
testicles	testicles
slimeball	slimeb*ll
Bootycall	Bootyc*ll
dumbbitch	dumbbitch
nigerians	nigeri*ns
fuckbuddy	fuckbuddy
Cumjockey	Cumjockey
Sweetness	Sweetness
cockqueen	cockqueen
Cocktease	Cockte*se
skankfuck	sk*nkfuck
pubiclice	pubiclice
Mastabate	M*st*b*te
asslicker	*sslicker
prickhead	prickhe*d
Cockrider	Cockrider
mastabate	m*st*b*te
Cigarette	Cig*rette
clamdiver	cl*mdiver
Kumbullbe	Kumbullbe
gatorbait	g*torb*it
Nastyslut	N*styslut
Threesome	Threesome
niggardly	nigg*rdly
Swallower	Sw*llower
niggarded	nigg*rded
criminals	crimin*ls
penthouse	penthouse
cocklover	cocklover
Sleezebag	Sleezeb*g
yellowman	yellowm*n
Clamdiver	Cl*mdiver
dixiedike	dixiedike
slaughter	sl*ughter
niggard's	nigg*rd's
towelhead	towelhe*d
Fuckbuddy	Fuckbuddy
primetime	primetime
feltching	feltching
goddamned	godd*mned
bitchslap	bitchsl*p
nigglings	nigglings
slutwhore	slutwhore
Fornicate	Fornic*te
sexkitten	sexkitten
Premature	Prem*ture
titlicker	titlicker
Dumbbitch	Dumbbitch
bi-sexual	bi-sexu*l
assmonkey	*ssmonkey
Communist	Communist
butt-fuck	butt-fuck
Christian	Christi*n
Muffdiver	Muffdiver
Mothafuck	Moth*fuck
Fuckfreak	Fuckfre*k
goddamnit	godd*mnit
sixsixsix	sixsixsix
goddamnes	godd*mnes
dickbrain	dickbr*in
Testicles	Testicles
Butt-bang	Butt-b*ng
kumbullbe	kumbullbe
shitfaced	shitf*ced
Hitlerism	Hitlerism
Disturbed	Disturbed
damnation	d*mn*tion
Execution	Execution
butchdyke	butchdyke
Niggardly	Nigg*rdly
Terrorist	Terrorist
suckmytit	suckmytit
Fatfucker	F*tfucker
Dragqueen	Dr*gqueen
asspacker	*ssp*cker
Butchdyke	Butchdyke
Dixiedike	Dixiedike
Dragqween	Dr*gqween
Towelhead	Towelhe*d
butt-bang	butt-b*ng
Assmonkey	Assmonkey
Bicurious	Bicurious
assfucker	*ssfucker
Splittail	Splitt*il
shitstain	shitst*in
slopehead	slopehe*d
Explosion	Explosion
Asspacker	Assp*cker
buttmunch	buttmunch
cocktease	cockte*se
Kumbubble	Kumbubble
threesome	threesome
freakfuck	fre*kfuck
Upthebutt	Upthebutt
sexy-slim	sexy-slim
Crotchrot	Crotchrot
Nigglings	Nigglings
Sixtynine	Sixtynine
asspirate	*sspir*te
cockrider	cockrider
Pornflick	Pornflick
Criminals	Crimin*ls
premature	prem*ture
dragqween	dr*gqween
Skinflute	Skinflute
Yellowman	Yellowm*n
Fuckwhore	Fuckwhore
splittail	splitt*il
Cockfight	Cockfight
Skankfuck	Sk*nkfuck
rentafuck	rent*fuck
fuckwhore	fuckwhore
Sexkitten	Sexkitten
Pimpjuice	Pimpjuice
nutfucker	nutfucker
crotchrot	crotchrot
Butchdike	Butchdike
Cockqueen	Cockqueen
hottotrot	hottotrot
Hijacking	Hij*cking
Rentafuck	Rent*fuck
Titfuckin	Titfuckin
analannie	*n*l*nnie
loadedgun	lo*dedgun
cigarette	cig*rette
Hitlerist	Hitlerist
scallywag	sc*llyw*g
moneyshot	moneyshot
shiteater	shite*ter
Bi-sexual	Bi-sexu*l
dragqueen	dr*gqueen
Cocksucer	Cocksucer
Shitstain	Shitst*in
Hottotrot	Hottotrot
excrement	excrement
christian	christi*n
breastjob	bre*stjob
cockfight	cockfight
Pubiclice	Pubiclice
communist	communist
Cockblock	Cockblock
suckmyass	suckmy*ss
hijacking	hij*cking
mothafuck	moth*fuck
titfucker	titfucker
Pussylips	Pussylips
Assbagger	Assb*gger
Damnation	D*mn*tion
sleezebag	sleezeb*g
bicurious	bicurious
Bountybar	Bountyb*r
Excrement	Excrement
horseshit	horseshit
Butt-fuck	Butt-fuck
Goddammit	Godd*mmit
assranger	*ssr*nger
catholics	c*tholics
shithouse	shithouse
kumbubble	kumbubble
Cocksmith	Cocksmith
Picaninny	Pic*ninny
Prickhead	Prickhe*d
Cumbubble	Cumbubble
Shortfuck	Shortfuck
Nutfucker	Nutfucker
Goddamned	Godd*mned
Bitchslap	Bitchsl*p
Goddamnes	Godd*mnes
hitlerism	hitlerism
cocksucer	cocksucer
thicklips	thicklips
assjockey	*ssjockey
sixtynine	sixtynine
Inthebuff	Inthebuff
breastman	bre*stm*n
Lovejuice	Lovejuice
Scallywag	Sc*llyw*g
Asspirate	Asspir*te
Niggard's	Nigg*rd's
Slimeball	Slimeb*ll
trisexual	trisexu*l
inthebuff	inthebuff
bootycall	bootyc*ll
dixiedyke	dixiedyke
Gatorbait	G*torb*it
Dickbrain	Dickbr*in
Thicklips	Thicklips
Sixsixsix	Sixsixsix
Shiteater	Shite*ter
muffdiver	muffdiver
Slideitin	Slideitin
nastyslut	n*styslut
Assjockey	Assjockey
Snigger's	Snigger's
Breastman	Bre*stm*n
Slopehead	Slopehe*d
crackpipe	cr*ckpipe
Niggarded	Nigg*rded
terrorist	terrorist
narcotic	n*rcotic
Homicide	Homicide
Roundeye	Roundeye
Headfuck	He*dfuck
Threeway	Threew*y
hijacker	hij*cker
Sniggers	Sniggers
cockknob	cockknob
homicide	homicide
lapdance	l*pd*nce
cocktail	cockt*il
diseases	dise*ses
Buttplug	Buttplug
Felching	Felching
niggards	nigg*rds
Phonesex	Phonesex
bullshit	bullshit
testicle	testicle
murderer	murderer
ballsack	b*lls*ck
freefuck	freefuck
Footfuck	Footfuck
cunteyed	cunteyed
Foursome	Foursome
screwyou	screwyou
Abortion	Abortion
jackshit	j*ckshit
muffdive	muffdive
buttface	buttf*ce
Fuckface	Fuckf*ce
vibrator	vibr*tor
Copulate	Copul*te
niggling	niggling
sexhound	sexhound
Bullcrap	Bullcr*p
jizjuice	jizjuice
snowback	snowb*ck
lovebone	lovebone
Filipino	Filipino
backseat	b*ckse*t
bisexual	bisexu*l
coloured	coloured
Eatpussy	E*tpussy
Butthead	Butthe*d
fuckedup	fuckedup
Horniest	Horniest
sniggers	sniggers
Retarded	Ret*rded
Shagging	Sh*gging
executed	executed
sodomize	sodomize
cemetery	cemetery
Criminal	Crimin*l
Redlight	Redlight
playgirl	pl*ygirl
Datnigga	D*tnigg*
Testicle	Testicle
Givehead	Givehe*d
barfface	b*rff*ce
Nigerian	Nigeri*n
filipina	filipin*
sexhouse	sexhouse
Defecate	Defec*te
Cockhead	Cockhe*d
datnigga	d*tnigg*
Vietcong	Vietcong
shitface	shitf*ce
roundeye	roundeye
bunghole	bunghole
chinamen	chin*men
chinaman	chin*m*n
Sodomise	Sodomise
bullcrap	bullcr*p
fuckfest	fuckfest
Peepshow	Peepshow
manhater	m*nh*ter
clitoris	clitoris
Erection	Erection
Filipina	Filipin*
Lapdance	L*pd*nce
Jackshit	J*ckshit
Ballsack	B*lls*ck
thirdeye	thirdeye
Buttfuck	Buttfuck
sexually	sexu*lly
Narcotic	N*rcotic
Thirdeye	Thirdeye
dripdick	dripdick
dickless	dickless
Assholes	Assholes
Barfface	B*rff*ce
Cocksuck	Cocksuck
assmunch	*ssmunch
Pussycat	Pussyc*t
Uptheass	Upthe*ss
Thirdleg	Thirdleg
Knockers	Knockers
Fuckable	Fuck*ble
Slutwear	Slutwe*r
Mosshead	Mosshe*d
spermbag	spermb*g
Shitlist	Shitlist
footfuck	footfuck
fuckface	fuckf*ce
retarded	ret*rded
Lovebone	Lovebone
foreskin	foreskin
Cunteyed	Cunteyed
minority	minority
blackout	bl*ckout
Nigger's	Nigger's
Screwyou	Screwyou
Sexhouse	Sexhouse
Bullshit	Bullshit
foursome	foursome
stroking	stroking
Tuckahoe	Tuck*hoe
sexwhore	sexwhore
Spigotty	Spigotty
buttbang	buttb*ng
footstar	footst*r
syphilis	syphilis
swastika	sw*stik*
Assassin	Ass*ssin
canadian	c*n*di*n
gotohell	gotohell
abortion	*bortion
Dickless	Dickless
assklown	*ssklown
Cumqueen	Cumqueen
pimpjuic	pimpjuic
Arsehole	Arsehole
Sexhound	Sexhound
goddamit	godd*mit
Bulldike	Bulldike
cocksman	cocksm*n
Fuckhead	Fuckhe*d
Assclown	Assclown
defecate	defec*te
Cockknob	Cockknob
Stringer	Stringer
Dicklick	Dicklick
dicklick	dicklick
Coloured	Coloured
easyslut	e*syslut
Canadian	C*n*di*n
pornking	pornking
buggered	buggered
gonzagas	gonz*g*s
felching	felching
Suckdick	Suckdick
Shitfull	Shitfull
Bisexual	Bisexu*l
blackman	bl*ckm*n
fellatio	fell*tio
Jizjuice	Jizjuice
Dumbfuck	Dumbfuck
Cemetery	Cemetery
godammit	god*mmit
mosshead	mosshe*d
Cocktail	Cockt*il
fuckknob	fuckknob
Spermbag	Spermb*g
Fucktard	Fuckt*rd
molestor	molestor
shitdick	shitdick
Dickweed	Dickweed
Manpaste	M*np*ste
Sodomite	Sodomite
beastial	be*sti*l
Executed	Executed
Vibrator	Vibr*tor
vibrater	vibr*ter
cockhead	cockhe*d
knockers	knockers
nigerian	nigeri*n
Muffdive	Muffdive
molester	molester
Asswhore	Asswhore
hotpussy	hotpussy
Radicals	R*dic*ls
Italiano	It*li*no
Fuckfest	Fuckfest
shitlist	shitlist
vietcong	vietcong
phukking	phukking
Fuckedup	Fuckedup
european	europe*n
Sodomize	Sodomize
Buggered	Buggered
Chinaman	Chin*m*n
nigger's	nigger's
Gotohell	Gotohell
Diseases	Dise*ses
Easyslut	E*syslut
Slanteye	Sl*nteye
slanteye	sl*nteye
shagging	sh*gging
lingerie	lingerie
Jijjiboo	Jijjiboo
Sexwhore	Sexwhore
violence	violence
Shitting	Shitting
bulldike	bulldike
Minority	Minority
Blackout	Bl*ckout
shitfuck	shitfuck
pimpsimp	pimpsimp
Lingerie	Lingerie
Assmunch	Assmunch
Dipstick	Dipstick
Dickhead	Dickhe*d
Feltcher	Feltcher
Bulldyke	Bulldyke
threeway	threew*y
Sexymoma	Sexymom*
Godammit	God*mmit
Fuckknob	Fuckknob
erection	erection
pussycat	pussyc*t
Swastika	Sw*stik*
slutwear	slutwe*r
Titlover	Titlover
cuntlick	cuntlick
shitfull	shitfull
Foreskin	Foreskin
cybersex	cybersex
Clitoris	Clitoris
Limpdick	Limpdick
Phukking	Phukking
cornhole	cornhole
Gangbang	G*ngb*ng
meatrack	me*tr*ck
Japanese	J*p*nese
Fistfuck	Fistfuck
Buttbang	Buttb*ng
buttfuck	buttfuck
Violence	Violence
Murderer	Murderer
Bunghole	Bunghole
fucktard	fuckt*rd
European	Europe*n
cuntfuck	cuntfuck
Shooting	Shooting
beat-off	be*t-off
givehead	givehe*d
japanese	j*p*nese
Asslover	Asslover
Shithead	Shithe*d
Cornhole	Cornhole
Assklown	Assklown
ontherag	onther*g
showtime	showtime
tuckahoe	tuck*hoe
israel's	isr*el's
spigotty	spigotty
suckdick	suckdick
fuckhead	fuckhe*d
Sexually	Sexu*lly
criminal	crimin*l
headfuck	he*dfuck
Shitface	Shitf*ce
Shitdick	Shitdick
Ontherag	Onther*g
Niggards	Nigg*rds
Beat-off	Be*t-off
intheass	inthe*ss
sodomite	sodomite
sodomise	sodomise
sexymoma	sexymom*
Footstar	Footst*r
Intheass	Inthe*ss
Beastial	Be*sti*l
butthead	butthe*d
Pimpsimp	Pimpsimp
phonesex	phonesex
Hijacker	Hij*cker
Fastfuck	F*stfuck
Showtime	Showtime
asslover	*sslover
Pimpjuic	Pimpjuic
Goddamit	Godd*mit
Pisshead	Pisshe*d
shithead	shithe*d
jijjiboo	jijjiboo
Pornking	Pornking
Chinamen	Chin*men
dumbfuck	dumbfuck
uptheass	upthe*ss
gangbang	g*ngb*ng
Manhater	M*nh*ter
filipino	filipino
Henhouse	Henhouse
Gonzagas	Gonz*g*s
american	*meric*n
titlover	titlover
Bitching	Bitching
Molester	Molester
eatballs	e*tb*lls
eatpussy	e*tpussy
dipstick	dipstick
Playgirl	Pl*ygirl
Sexslave	Sexsl*ve
shooting	shooting
Vibrater	Vibr*ter
Dripdick	Dripdick
radicals	r*dic*ls
Cuntfuck	Cuntfuck
asswhore	*sswhore
poontang	poont*ng
cumqueen	cumqueen
Snowback	Snowb*ck
assclown	*ssclown
Slutting	Slutting
pisshead	pisshe*d
Cocksman	Cocksm*n
Fellatio	Fell*tio
bazongas	b*zong*s
Cameltoe	C*meltoe
Hotpussy	Hotpussy
American	Americ*n
assassin	*ss*ssin
Bazongas	B*zong*s
cocksuck	cocksuck
henhouse	henhouse
sexslave	sexsl*ve
backdoor	b*ckdoor
Backseat	B*ckse*t
bulldyke	bulldyke
Catholic	C*tholic
Shitfuck	Shitfuck
Blackman	Bl*ckm*n
Backdoor	B*ckdoor
assholes	*ssholes
thirdleg	thirdleg
Syphilis	Syphilis
Poontang	Poont*ng
buttplug	buttplug
manpaste	m*np*ste
cameltoe	c*meltoe
Niggling	Niggling
slutting	slutting
arsehole	*rsehole
bitching	bitching
stringer	stringer
dickweed	dickweed
peepshow	peepshow
redlight	redlight
limpdick	limpdick
Buttface	Buttf*ce
Peepshpw	Peepshpw
fuckable	fuck*ble
Cuntlick	Cuntlick
fastfuck	f*stfuck
feltcher	feltcher
Molestor	Molestor
copulate	copul*te
Eatballs	E*tb*lls
fistfuck	fistfuck
Stroking	Stroking
Freefuck	Freefuck
Israel's	Isr*el's
peepshpw	peepshpw
italiano	it*li*no
Meatrack	Me*tr*ck
Cybersex	Cybersex
horniest	horniest
shitting	shitting
catholic	c*tholic
dickhead	dickhe*d
poverty	poverty
cumshot	cumshot
colored	colored
bitchez	bitchez
Lesbain	Lesb*in
Reestie	Reestie
lesbian	lesbi*n
drunken	drunken
pooping	pooping
Bombing	Bombing
hotdamn	hotd*mn
negro's	negro's
Lucifer	Lucifer
Bastard	B*st*rd
Lovegoo	Lovegoo
Suicide	Suicide
dumbass	dumb*ss
fagging	f*gging
jiggabo	jigg*bo
sexfarm	sexf*rm
Mulatto	Mul*tto
niggard	nigg*rd
Peehole	Peehole
Genital	Genit*l
Shitter	Shitter
Bitcher	Bitcher
Funfuck	Funfuck
lucifer	lucifer
japcrap	j*pcr*p
Pissing	Pissing
liberal	liber*l
Urinary	Urin*ry
juggalo	jugg*lo
welfare	welf*re
Liberal	Liber*l
Torture	Torture
Whigger	Whigger
Pindick	Pindick
Quashie	Qu*shie
quashie	qu*shie
Phuking	Phuking
asshole	*sshole
Quickie	Quickie
bastard	b*st*rd
Felatio	Fel*tio
Wetback	Wetb*ck
snigger	snigger
Sheeney	Sheeney
urinary	urin*ry
Hotdamn	Hotd*mn
Felcher	Felcher
Dipshit	Dipshit
negroes	negroes
titfuck	titfuck
whigger	whigger
Bollock	Bollock
Servant	Serv*nt
Fuckers	Fuckers
Amateur	Am*teur
Swallow	Sw*llow
Jerkoff	Jerkoff
Welcher	Welcher
Cumming	Cumming
Pissoff	Pissoff
killing	killing
pussies	pussies
fuckbag	fuckb*g
servant	serv*nt
Fairies	F*iries
assault	*ss*ult
Pansies	P*nsies
pissing	pissing
Bumfuck	Bumfuck
Assault	Ass*ult
niggers	niggers
Dickman	Dickm*n
Puddboy	Puddboy
baptist	b*ptist
Cumquat	Cumqu*t
lesbayn	lesb*yn
Buggery	Buggery
jackass	j*ck*ss
Analsex	An*lsex
Panties	P*nties
Twinkie	Twinkie
urinate	urin*te
Radical	R*dic*l
Rimming	Rimming
skumbag	skumb*g
Disease	Dise*se
negroid	negroid
Bondage	Bond*ge
bumfuck	bumfuck
Vaginal	V*gin*l
carruth	c*rruth
analsex	*n*lsex
Shitcan	Shitc*n
mulatto	mul*tto
swallow	sw*llow
rearend	re*rend
Shitola	Shitol*
Goddamn	Godd*mn
remains	rem*ins
Refugee	Refugee
Lactate	L*ct*te
Kumming	Kumming
Jigaboo	Jig*boo
lovegun	lovegun
rimming	rimming
Colored	Colored
Shiting	Shiting
Crapper	Cr*pper
dickwad	dickw*d
niggles	niggles
Redneck	Redneck
goddamn	godd*mn
asshore	*sshore
tarbaby	t*rb*by
buggery	buggery
whacker	wh*cker
Bitchez	Bitchez
Triplex	Triplex
Fuckbag	Fuckb*g
strapon	str*pon
niggled	niggled
amateur	*m*teur
shitted	shitted
gangsta	g*ngst*
Baptist	B*ptist
muncher	muncher
Fuckina	Fuckin*
Shaggin	Sh*ggin
triplex	triplex
Jiggabo	Jigg*bo
honkers	honkers
cocaine	coc*ine
Beatoff	Be*toff
Russkie	Russkie
dipshit	dipshit
Asslick	Asslick
badfuck	b*dfuck
Farting	F*rting
mexican	mexic*n
Coondog	Coondog
genital	genit*l
torture	torture
Fisting	Fisting
russkie	russkie
disease	dise*se
suicide	suicide
bollick	bollick
lesbain	lesb*in
Fuckyou	Fuckyou
Wetspot	Wetspot
shitfit	shitfit
Clogwog	Clogwog
bitchin	bitchin
Trannie	Tr*nnie
boobies	boobies
Mexican	Mexic*n
kumming	kumming
puddboy	puddboy
kumquat	kumqu*t
barface	b*rf*ce
Juggalo	Jugg*lo
israeli	isr*eli
Barface	B*rf*ce
Nastyho	N*styho
Penises	Penises
reestie	reestie
phukked	phukked
Spitter	Spitter
pansies	p*nsies
Cocaine	Coc*ine
Illegal	Illeg*l
Vatican	V*tic*n
Honkers	Honkers
Execute	Execute
asswipe	*sswipe
slapper	sl*pper
Suckoff	Suckoff
clogwog	clogwog
Asshore	Asshore
fuckers	fuckers
Shinola	Shinol*
Hooters	Hooters
Negroes	Negroes
quickie	quickie
Sextoys	Sextoys
Fagging	F*gging
penises	penises
Urinate	Urin*te
lowlife	lowlife
Israeli	Isr*eli
Cumshot	Cumshot
Strapon	Str*pon
welcher	welcher
Niggles	Niggles
kissass	kiss*ss
Drunken	Drunken
shiting	shiting
Lovegun	Lovegun
Lubejob	Lubejob
Titties	Titties
Fuckoff	Fuckoff
titties	titties
Gangsta	G*ngst*
wanking	w*nking
phuking	phuking
bondage	bond*ge
bigbutt	bigbutt
fuckyou	fuckyou
Lesbian	Lesbi*n
shinola	shinol*
bitcher	bitcher
handjob	h*ndjob
doo-doo	doo-doo
funeral	funer*l
Orgasim	Org*sim
Fatfuck	F*tfuck
sextogo	sextogo
Snigger	Snigger
Blowjob	Blowjob
Wanking	W*nking
pindick	pindick
Kumquat	Kumqu*t
Hiscock	Hiscock
Welfare	Welf*re
Bitchin	Bitchin
Funeral	Funer*l
Brothel	Brothel
brothel	brothel
Carruth	C*rruth
bollock	bollock
Addicts	Addicts
Jackoff	J*ckoff
orgasim	org*sim
Tarbaby	T*rb*by
assfuck	*ssfuck
jigaboo	jig*boo
hosejob	hosejob
Niggard	Nigg*rd
Buttman	Buttm*n
Rearend	Re*rend
Hosejob	Hosejob
playboy	pl*yboy
mideast	mide*st
puntang	punt*ng
phungky	phungky
Deposit	Deposit
Skumbag	Skumb*g
bitches	bitches
Schlong	Schlong
Bestial	Besti*l
Hookers	Hookers
Remains	Rem*ins
shaggin	sh*ggin
spitter	spitter
livesex	livesex
Muncher	Muncher
Livesex	Livesex
Whiskey	Whiskey
scrotum	scrotum
jimfish	jimfish
Aroused	Aroused
Jimfish	Jimfish
asslick	*sslick
Lesbayn	Lesb*yn
Ecstacy	Ecst*cy
Pussies	Pussies
Pooping	Pooping
ecstacy	ecst*cy
Lowlife	Lowlife
trannie	tr*nnie
women's	women's
Jackass	J*ck*ss
Pee-pee	Pee-pee
vatican	v*tic*n
Slapper	Sl*pper
asskiss	*sskiss
Niggers	Niggers
Asshole	Asshole
Fuckher	Fuckher
Puntang	Punt*ng
fairies	f*iries
cumming	cumming
addicts	*ddicts
cumquat	cumqu*t
Kissass	Kiss*ss
whiskey	whiskey
jackoff	j*ckoff
Hostage	Host*ge
illegal	illeg*l
fucking	fucking
hostage	host*ge
shitter	shitter
cumfest	cumfest
Whacker	Wh*cker
crapper	cr*pper
Boobies	Boobies
sheeney	sheeney
pissoff	pissoff
schlong	schlong
bombing	bombing
fuckina	fuckin*
chinese	chinese
Cumfest	Cumfest
fuckoff	fuckoff
getiton	getiton
Niggled	Niggled
waysted	w*ysted
Mideast	Mide*st
hooters	hooters
lovegoo	lovegoo
bestial	besti*l
Banging	B*nging
Phukked	Phukked
Cocknob	Cocknob
Dumbass	Dumb*ss
bombers	bombers
Handjob	H*ndjob
Women's	Women's
Raghead	R*ghe*d
hustler	hustler
Waysted	W*ysted
bazooms	b*zooms
dickman	dickm*n
Titfuck	Titfuck
Badfuck	B*dfuck
sextoys	sextoys
raghead	r*ghe*d
Bazooms	B*zooms
Bollick	Bollick
Playboy	Pl*yboy
wetspot	wetspot
vaginal	v*gin*l
twinkie	twinkie
Sexfarm	Sexf*rm
Shitfit	Shitfit
coondog	coondog
Phungky	Phungky
African	Afric*n
hookers	hookers
blowjob	blowjob
Negro's	Negro's
felatio	fel*tio
nastyho	n*styho
deposit	deposit
Bombers	Bombers
panties	p*nties
fatfuck	f*tfuck
felcher	felcher
aroused	*roused
Asskiss	Asskiss
Shitted	Shitted
Negroid	Negroid
Chinese	Chinese
redneck	redneck
Scrotum	Scrotum
fuckher	fuckher
Bitches	Bitches
Getiton	Getiton
funfuck	funfuck
upskirt	upskirt
jerkoff	jerkoff
Destroy	Destroy
Fucking	Fucking
shitola	shitol*
fisting	fisting
Killing	Killing
refugee	refugee
lactate	l*ct*te
beatoff	be*toff
shitcan	shitc*n
Poverty	Poverty
failure	f*ilure
Bigbutt	Bigbutt
lubejob	lubejob
Fuckpig	Fuckpig
suckoff	suckoff
pee-pee	pee-pee
execute	execute
wetback	wetb*ck
african	*fric*n
Asswipe	Asswipe
Hustler	Hustler
farting	f*rting
radical	r*dic*l
peehole	peehole
destroy	destroy
cocknob	cocknob
flasher	fl*sher
Japcrap	J*pcr*p
buttman	buttm*n
Failure	F*ilure
Dickwad	Dickw*d
crapola	cr*pol*
hiscock	hiscock
banging	b*nging
Doo-doo	Doo-doo
Crapola	Cr*pol*
Assfuck	Assfuck
Flasher	Fl*sher
Sextogo	Sextogo
fuckpig	fuckpig
Upskirt	Upskirt
Areola	Areol*
Racial	R*ci*l
escort	escort
pistol	pistol
Tortur	Tortur
nookie	nookie
Gyppie	Gyppie
krappy	kr*ppy
Babies	B*bies
robber	robber
Africa	Afric*
Nooner	Nooner
Incest	Incest
nudger	nudger
fuckit	fuckit
chinky	chinky
Failed	F*iled
Tittie	Tittie
Slopey	Slopey
Kanake	K*n*ke
Iblowu	Iblowu
Gringo	Gringo
pommie	pommie
Pooper	Pooper
Hummer	Hummer
Tantra	T*ntr*
moslem	moslem
firing	firing
shited	shited
retard	ret*rd
kondum	kondum
Noonan	Noon*n
dammit	d*mmit
Toilet	Toilet
mockie	mockie
rectum	rectum
weapon	we*pon
Zigabo	Zig*bo
pisser	pisser
pecker	pecker
Tosser	Tosser
feltch	feltch
Escort	Escort
niggor	niggor
Nudger	Nudger
sniper	sniper
Darkie	D*rkie
kigger	kigger
period	period
Kigger	Kigger
gringo	gringo
killed	killed
nittit	nittit
Swalow	Sw*low
Wanker	W*nker
tortur	tortur
darkie	d*rkie
Weenie	Weenie
Farted	F*rted
Fister	Fister
soviet	soviet
spunky	spunky
hitler	hitler
suckme	suckme
dahmer	d*hmer
Sucker	Sucker
Rapist	R*pist
turnon	turnon
Hijack	Hij*ck
gummer	gummer
bigger	bigger
hooker	hooker
Pudboy	Pudboy
skanky	sk*nky
Jizzum	Jizzum
Dahmer	D*hmer
stiffy	stiffy
Mormon	Mormon
crappy	cr*ppy
Pimped	Pimped
Wigger	Wigger
horney	horney
Tampon	T*mpon
flydye	flydye
reefer	reefer
Orgasm	Org*sm
Turnon	Turnon
Slutty	Slutty
diddle	diddle
Feltch	Feltch
willie	willie
creamy	cre*my
liquor	liquor
Israel	Isr*el
whitey	whitey
honger	honger
Titjob	Titjob
niggur	niggur
Rectum	Rectum
Nignog	Nignog
Attack	Att*ck
faggot	f*ggot
wanker	w*nker
Commie	Commie
Stroke	Stroke
Christ	Christ
Period	Period
Condom	Condom
Liquor	Liquor
Addict	Addict
sexpot	sexpot
Hodgie	Hodgie
bugger	bugger
Vagina	V*gin*
Reefer	Reefer
slutty	slutty
Creamy	Cre*my
popimp	popimp
Looser	Looser
coitus	coitus
titjob	titjob
Hooker	Hooker
Chinky	Chinky
breast	bre*st
Sexpot	Sexpot
Nookie	Nookie
Phuked	Phuked
insest	insest
orgasm	org*sm
Krappy	Kr*ppy
pisses	pisses
Tranny	Tr*nny
faeces	f*eces
yankee	y*nkee
Molest	Molest
farted	f*rted
sucker	sucker
beaver	be*ver
Racist	R*cist
Assman	Assm*n
virgin	virgin
Asshat	Assh*t
Geezer	Geezer
tosser	tosser
jigger	jigger
kaffir	k*ffir
Orgies	Orgies
Cacker	C*cker
herpes	herpes
iblowu	iblowu
biatch	bi*tch
Pissed	Pissed
blacks	bl*cks
Mockie	Mockie
Lotion	Lotion
pissed	pissed
toilet	toilet
Killed	Killed
Hitler	Hitler
Nigger	Nigger
dyefly	dyefly
polack	pol*ck
reject	reject
Kaffre	K*ffre
looser	looser
Niggle	Niggle
hummer	hummer
sextoy	sextoy
Tinkle	Tinkle
fckcum	fckcum
Dyefly	Dyefly
Fuckin	Fuckin
Licker	Licker
Gaysex	G*ysex
Fondle	Fondle
cacker	c*cker
Uterus	Uterus
racist	r*cist
killer	killer
Damnit	D*mnit
Sexual	Sexu*l
weenie	weenie
pimped	pimped
Fungus	Fungus
Fuckme	Fuckme
noonan	noon*n
German	Germ*n
Nookey	Nookey
terror	terror
kanake	k*n*ke
Fucked	Fucked
fuckin	fuckin
Niggur	Niggur
tinkle	tinkle
Sniper	Sniper
nooner	nooner
honkey	honkey
Ethnic	Ethnic
Pisses	Pisses
Diddle	Diddle
molest	molest
byatch	by*tch
nipple	nipple
sexing	sexing
Bugger	Bugger
Reject	Reject
fucked	fucked
Weewee	Weewee
Coitus	Coitus
Fetish	Fetish
lotion	lotion
fatass	f*t*ss
Flange	Fl*nge
tittie	tittie
Pissin	Pissin
Robber	Robber
doodoo	doodoo
Willie	Willie
babies	b*bies
pimper	pimper
stupid	stupid
jizzim	jizzim
licker	licker
Pistol	Pistol
Pisser	Pisser
commie	commie
attack	*tt*ck
hindoo	hindoo
Ribbed	Ribbed
Gummer	Gummer
Rimjob	Rimjob
Hardon	H*rdon
Polack	Pol*ck
Boonie	Boonie
Retard	Ret*rd
Stiffy	Stiffy
sodomy	sodomy
flange	fl*nge
Niggah	Nigg*h
lesbin	lesbin
Niglet	Niglet
zigabo	zig*bo
Fatass	F*t*ss
biteme	biteme
Libido	Libido
Macaca	M*c*c*
nlggor	nlggor
Boonga	Boong*
hardon	h*rdon
gaysex	g*ysex
addict	*ddict
muslim	muslim
Niggaz	Nigg*z
Lolita	Lolit*
Cunntt	Cunntt
cummer	cummer
fuckme	fuckme
coolie	coolie
Murder	Murder
hijack	hij*ck
Weapon	We*pon
kummer	kummer
Heroin	Heroin
desire	desire
Nlgger	Nlgger
Crappy	Cr*ppy
Spooge	Spooge
rapist	r*pist
Virgin	Virgin
areola	*reol*
libido	libido
Desire	Desire
Spunky	Spunky
Bitchy	Bitchy
fucker	fucker
kaffre	k*ffre
Snatch	Sn*tch
swalow	sw*low
Nlggor	Nlggor
kaffer	k*ffer
Suckme	Suckme
tantra	t*ntr*
Faggot	F*ggot
tampon	t*mpon
wigger	wigger
Beaner	Be*ner
Bigass	Big*ss
Harder	H*rder
Honkey	Honkey
russki	russki
Pecker	Pecker
condom	condom
christ	christ
Beaver	Be*ver
Crotch	Crotch
Pimper	Pimper
Biatch	Bi*tch
pussie	pussie
Breast	Bre*st
boonga	boong*
Cancer	C*ncer
Pussie	Pussie
Mockey	Mockey
Killer	Killer
Jigger	Jigger
lickme	lickme
Whites	Whites
german	germ*n
Horney	Horney
israel	isr*el
Muslim	Muslim
ethnic	ethnic
Hindoo	Hindoo
Fucker	Fucker
snatch	sn*tch
racial	r*ci*l
buried	buried
brea5t	bre*5t
Doodoo	Doodoo
Niggor	Niggor
mormon	mormon
Faeces	F*eces
tranny	tr*nny
Lesbin	Lesbin
bohunk	bohunk
Yankee	Y*nkee
Wuzzie	Wuzzie
vagina	v*gin*
Shited	Shited
nignog	nignog
Fckcum	Fckcum
lolita	lolit*
nigger	nigger
niglet	niglet
Insest	Insest
Cummer	Cummer
church	church
Flydye	Flydye
asshat	*ssh*t
Trojan	Troj*n
Sexing	Sexing
crimes	crimes
Russki	Russki
mockey	mockey
crotch	crotch
Blacks	Bl*cks
Herpes	Herpes
Honger	Honger
Fuckit	Fuckit
hodgie	hodgie
Sodomy	Sodomy
Nittit	Nittit
heroin	heroin
Church	Church
Buried	Buried
Shitty	Shitty
fungus	fungus
wuzzie	wuzzie
rigger	rigger
Coolie	Coolie
damnit	d*mnit
Kaffir	K*ffir
orgies	orgies
Penile	Penile
rimjob	rimjob
trojan	troj*n
penile	penile
Kaffer	K*ffer
shitty	shitty
Whitey	Whitey
fister	fister
Popimp	Popimp
Stupid	Stupid
phuked	phuked
jizzum	jizzum
niggle	niggle
sexual	sexu*l
macaca	m*c*c*
Firing	Firing
beaner	be*ner
jewish	jewish
Sextoy	Sextoy
ribbed	ribbed
geezer	geezer
tongue	tongue
murder	murder
boonie	boonie
Lickme	Lickme
Tongue	Tongue
Kummer	Kummer
Jewish	Jewish
Flydie	Flydie
nookey	nookey
niggah	nigg*h
incest	incest
whites	whites
Nipple	Nipple
africa	*fric*
Moslem	Moslem
Kondum	Kondum
Terror	Terror
bigass	big*ss
weewee	weewee
Soviet	Soviet
niggaz	nigg*z
failed	f*iled
Pommie	Pommie
Crimes	Crimes
nlgger	nlgger
Biteme	Biteme
fetish	fetish
Bigger	Bigger
uterus	uterus
slopey	slopey
Dammit	D*mmit
Rigger	Rigger
cancer	c*ncer
Skanky	Sk*nky
Brea5t	Bre*5t
Byatch	By*tch
spooge	spooge
pissin	pissin
cunntt	cunntt
pooper	pooper
Bohunk	Bohunk
assman	*ssm*n
pudboy	pudboy
gyppie	gyppie
bitchy	bitchy
Jizzim	Jizzim
fondle	fondle
harder	h*rder
stroke	stroke
flydie	flydie
bogan	bog*n
booby	booby
darky	d*rky
Taboo	T*boo
loser	loser
Moron	Moron
kills	kills
Moles	Moles
Devil	Devil
hoser	hoser
Pixie	Pixie
faith	f*ith
enemy	enemy
Lynch	Lynch
Roach	Ro*ch
Piker	Piker
Forni	Forni
bible	bible
negro	negro
balls	b*lls
ginzo	ginzo
Smack	Sm*ck
sooty	sooty
Titty	Titty
Porno	Porno
Vulva	Vulv*
fatah	f*t*h
urine	urine
cooly	cooly
Dildo	Dildo
Teste	Teste
Slave	Sl*ve
fucks	fucks
Crabs	Cr*bs
Rabbi	R*bbi
fight	fight
Loser	Loser
Negro	Negro
pixie	pixie
Fraud	Fr*ud
Boobs	Boobs
Girls	Girls
Boody	Boody
Fubar	Fub*r
Chode	Chode
Fight	Fight
moron	moron
fraud	fr*ud
Pocho	Pocho
lezbo	lezbo
Honky	Honky
gross	gross
Idiot	Idiot
boang	bo*ng
beast	be*st
sexed	sexed
Sandm	S*ndm
choad	cho*d
kotex	kotex
shits	shits
panti	p*nti
Semen	Semen
shite	shite
screw	screw
Death	De*th
Asian	Asi*n
Pikey	Pikey
sandm	s*ndm
fucck	fucck
Angie	Angie
pu55y	pu55y
crash	cr*sh
Whash	Wh*sh
trots	trots
niger	niger
black	bl*ck
slopy	slopy
fagot	f*got
naked	n*ked
Raped	R*ped
taboo	t*boo
bombs	bombs
Gyppo	Gyppo
feces	feces
whash	wh*sh
Boang	Bo*ng
Color	Color
usama	us*m*
Latin	L*tin
Ginzo	Ginzo
Hymie	Hymie
mgger	mgger
Harem	H*rem
Kafir	K*fir
Whore	Whore
Kraut	Kr*ut
shhit	shhit
lezzo	lezzo
Drunk	Drunk
Naked	N*ked
fugly	fugly
enema	enem*
Hamas	H*m*s
Slant	Sl*nt
abuse	*buse
Spank	Sp*nk
goyim	goyim
slutt	slutt
Hoser	Hoser
Spunk	Spunk
cra5h	cr*5h
sissy	sissy
hamas	h*m*s
Lesbo	Lesbo
lynch	lynch
Sodom	Sodom
Slutt	Slutt
hussy	hussy
Necro	Necro
Nymph	Nymph
Sperm	Sperm
raped	r*ped
Shits	Shits
Cohee	Cohee
Fugly	Fugly
boody	boody
Husky	Husky
boobs	boobs
Fuuck	Fuuck
mggor	mggor
Angry	Angry
Fairy	F*iry
Usama	Us*m*
piker	piker
Nigga	Nigg*
Goyim	Goyim
chode	chode
Raper	R*per
Vomit	Vomit
pocho	pocho
Shite	Shite
stagg	st*gg
Willy	Willy
gubba	gubb*
Lugan	Lug*n
mafia	m*fi*
slave	sl*ve
pansy	p*nsy
Spick	Spick
Cooly	Cooly
dirty	dirty
Pussy	Pussy
semen	semen
pendy	pendy
Stagg	St*gg
lezbe	lezbe
Fucck	Fucck
Pubic	Pubic
queef	queef
Lezbo	Lezbo
Pendy	Pendy
Felch	Felch
Penis	Penis
Eatme	E*tme
Sadis	S*dis
Horny	Horny
husky	husky
Enemy	Enemy
spick	spick
Sadom	S*dom
girls	girls
Crash	Cr*sh
harem	h*rem
Arabs	Ar*bs
fatso	f*tso
Screw	Screw
Gyppy	Gyppy
Lezbe	Lezbe
jebus	jebus
Jizim	Jizim
Booty	Booty
jiggy	jiggy
Urine	Urine
Fatso	F*tso
jesus	jesus
Boong	Boong
Abuse	Abuse
Fucka	Fuck*
jigga	jigg*
Farty	F*rty
Mocky	Mocky
nigga	nigg*
willy	willy
Queef	Queef
osama	os*m*
sodom	sodom
horny	horny
Seppo	Seppo
arabs	*r*bs
Kills	Kills
tramp	tr*mp
raper	r*per
Feces	Feces
twink	twink
pommy	pommy
Nasty	N*sty
spunk	spunk
vulva	vulv*
spank	sp*nk
Queer	Queer
Beast	Be*st
Randy	R*ndy
squaw	squ*w
Choad	Cho*d
boner	boner
asian	*si*n
hymie	hymie
penis	penis
Jigga	Jigg*
fucka	fuck*
Sissy	Sissy
Allah	All*h
bitch	bitch
Fucks	Fucks
Fatah	F*t*h
Tramp	Tr*mp
color	color
kinky	kinky
Hymen	Hymen
Black	Bl*ck
Fagot	F*got
kafir	k*fir
adult	*dult
Nigre	Nigre
skank	sk*nk
angie	*ngie
Pu55i	Pu55i
lugan	lug*n
Slopy	Slopy
Bogan	Bog*n
Mggor	Mggor
Pu55y	Pu55y
crime	crime
Knife	Knife
felch	felch
drunk	drunk
cocky	cocky
smack	sm*ck
demon	demon
seppo	seppo
Kinky	Kinky
kraut	kr*ut
sadis	s*dis
Cra5h	Cr*5h
sadom	s*dom
allah	*ll*h
Trots	Trots
fubar	fub*r
peni5	peni5
pu55i	pu55i
whore	whore
Peni5	Peni5
Bombs	Bombs
Lezzo	Lezzo
teste	teste
roach	ro*ch
joint	joint
eatme	e*tme
Bunga	Bung*
dildo	dildo
hymen	hymen
Shoot	Shoot
angry	*ngry
Sluts	Sluts
Pommy	Pommy
farty	f*rty
fuuck	fuuck
death	de*th
vomit	vomit
Shhit	Shhit
argie	*rgie
Twink	Twink
Panti	P*nti
jizim	jizim
pikey	pikey
Cocky	Cocky
Sexed	Sexed
slime	slime
Nigra	Nigr*
Booby	Booby
Joint	Joint
nigra	nigr*
crabs	cr*bs
crack	cr*ck
porno	porno
Argie	Argie
knife	knife
Chink	Chink
Blind	Blind
Crack	Cr*ck
Kotex	Kotex
Crime	Crime
Squaw	Squ*w
Prick	Prick
pocha	poch*
nasty	n*sty
nigre	nigre
gyppy	gyppy
Erect	Erect
Jebus	Jebus
Demon	Demon
queer	queer
Niger	Niger
bunga	bung*
pussy	pussy
randy	r*ndy
Enema	Enem*
Gross	Gross
Limey	Limey
fairy	f*iry
Balls	B*lls
rabbi	r*bbi
honky	honky
Jiggy	Jiggy
forni	forni
slant	sl*nt
boong	boong
Asses	Asses
Bible	Bible
Mafia	M*fi*
mocky	mocky
moles	moles
Jesus	Jesus
Dirty	Dirty
asses	*sses
limey	limey
Gubba	Gubb*
Darky	D*rky
Pocha	Poch*
prick	prick
idiot	idiot
Bitch	Bitch
erect	erect
jihad	jih*d
Hussy	Hussy
Faith	F*ith
titty	titty
Satan	S*t*n
devil	devil
blind	blind
necro	necro
Slime	Slime
Osama	Os*m*
satan	s*t*n
booty	booty
pubic	pubic
Adult	Adult
sluts	sluts
cohee	cohee
gyppo	gyppo
latin	l*tin
Boner	Boner
Jihad	Jih*d
Pansy	P*nsy
Skank	Sk*nk
Mgger	Mgger
Sooty	Sooty
shoot	shoot
sperm	sperm
nymph	nymph
lesbo	lesbo
chink	chink
ikey	ikey
jigg	jigg
bomd	bomd
Hell	Hell
Paki	P*ki
Skum	Skum
Nook	Nook
Anal	An*l
dope	dope
Rere	Rere
Hoes	Hoes
turd	turd
Fore	Fore
meth	meth
fuck	fuck
scum	scum
Piky	Piky
whiz	whiz
Piss	Piss
tard	t*rd
bast	b*st
cunt	cunt
nazi	n*zi
mams	m*ms
Hole	Hole
Pimp	Pimp
Nuke	Nuke
Cock	Cock
Babe	B*be
Slut	Slut
Fear	Fe*r
abbo	*bbo
spig	spig
pimp	pimp
jism	jism
rere	rere
kunt	kunt
scag	sc*g
slav	sl*v
hork	hork
orga	org*
Wank	W*nk
Pube	Pube
laid	l*id
Pric	Pric
Arab	Ar*b
Kink	Kink
peck	peck
Mofo	Mofo
Pixy	Pixy
cock	cock
Floo	Floo
dong	dong
skum	skum
Jizm	Jizm
groe	groe
muff	muff
pohm	pohm
krap	kr*p
Jism	Jism
shav	sh*v
Spig	Spig
Koon	Koon
Dead	De*d
Pi55	Pi55
Cunt	Cunt
Lies	Lies
chav	ch*v
Moky	Moky
boom	boom
jiga	jig*
Dike	Dike
Sexy	Sexy
Gypo	Gypo
Nazi	N*zi
Butt	Butt
gypo	gypo
pixy	pixy
Doom	Doom
cumm	cumm
teat	te*t
blow	blow
hore	hore
heeb	heeb
jugs	jugs
phuq	phuq
cigs	cigs
Hore	Hore
Bong	Bong
hebe	hebe
phuk	phuk
Arse	Arse
snot	snot
butt	butt
alla	*ll*
pric	pric
Porn	Porn
jizm	jizm
Drug	Drug
oral	or*l
Poop	Poop
Tard	T*rd
Burn	Burn
Died	Died
piss	piss
Perv	Perv
Fire	Fire
poon	poon
doom	doom
Jade	J*de
Jigg	Jigg
Kill	Kill
Pros	Pros
Poon	Poon
Blow	Blow
damn	d*mn
dago	d*go
kums	kums
vibr	vibr
Puss	Puss
Shat	Sh*t
Crap	Cr*p
Tits	Tits
Clit	Clit
shag	sh*g
hell	hell
bomb	bomb
dumb	dumb
Munt	Munt
tits	tits
Wetb	Wetb
fear	fe*r
nude	nude
jizz	jizz
anus	*nus
Meth	Meth
Gook	Gook
Dink	Dink
boob	boob
spik	spik
Geez	Geez
Lezz	Lezz
Honk	Honk
kike	kike
Dyke	Dyke
Taff	T*ff
nook	nook
Phuq	Phuq
kill	kill
Scat	Sc*t
Dago	D*go
slut	slut
milf	milf
Shav	Sh*v
Hebe	Hebe
whop	whop
spic	spic
wetb	wetb
Slav	Sl*v
porn	porn
scat	sc*t
Homo	Homo
drug	drug
Whiz	Whiz
Dive	Dive
dego	dego
barf	b*rf
payo	p*yo
lies	lies
Horn	Horn
Shag	Sh*g
Hapa	H*p*
Jeez	Jeez
pi55	pi55
puss	puss
Spit	Spit
Cigs	Cigs
whit	whit
ra8s	r*8s
Jizz	Jizz
perv	perv
died	died
Spik	Spik
Pusy	Pusy
honk	honk
Groe	Groe
rump	rump
shit	shit
Krap	Kr*p
Limy	Limy
nigr	nigr
Oral	Or*l
dyke	dyke
dead	de*d
Hobo	Hobo
Chav	Ch*v
Boom	Boom
Shit	Shit
Kock	Kock
fart	f*rt
Dick	Dick
poop	poop
Dumb	Dumb
geni	geni
hoes	hoes
mofo	mofo
Whit	Whit
pube	pube
Kyke	Kyke
fuks	fuks
dick	dick
orgy	orgy
Nigg	Nigg
burn	burn
Kums	Kums
spit	spit
anal	*n*l
hole	hole
twat	tw*t
piky	piky
Suck	Suck
Tang	T*ng
Heeb	Heeb
taff	t*ff
arab	*r*b
tang	t*ng
Nude	Nude
babe	b*be
nuke	nuke
Vibr	Vibr
wuss	wuss
Dies	Dies
pusy	pusy
fore	fore
moky	moky
Dong	Dong
Smut	Smut
Nigr	Nigr
cunn	cunn
Coon	Coon
gypp	gypp
kink	kink
Laid	L*id
jeez	jeez
sick	sick
koon	koon
puke	puke
arse	*rse
Sick	Sick
Payo	P*yo
Milf	Milf
hobo	hobo
Pudd	Pudd
Itch	Itch
Cumm	Cumm
Scag	Sc*g
Dego	Dego
Kike	Kike
suck	suck
horn	horn
Orgy	Orgy
pros	pros
lezz	lezz
Anus	Anus
Dope	Dope
munt	munt
Barf	B*rf
Cunn	Cunn
Fart	F*rt
Twat	Tw*t
Ikey	Ikey
Whop	Whop
Jugs	Jugs
Turd	Turd
Jiga	Jig*
Peck	Peck
hapa	h*p*
Phuk	Phuk
Gipp	Gipp
Puke	Puke
Ra8s	R*8s
paki	p*ki
dies	dies
limy	limy
deth	deth
Muff	Muff
Quim	Quim
Hook	Hook
Bomb	Bomb
Wuss	Wuss
Scum	Scum
Chin	Chin
Spic	Spic
Boob	Boob
fire	fire
hook	hook
dike	dike
kock	kock
nigg	nigg
coon	coon
sexy	sexy
Rump	Rump
Fuck	Fuck
clit	clit
Fuks	Fuks
dink	dink
shat	sh*t
kyke	kyke
smut	smut
floo	floo
Deth	Deth
chin	chin
Orga	Org*
Abbo	Abbo
pudd	pudd
itch	itch
Rape	R*pe
jade	j*de
gook	gook
Bomd	Bomd
Damn	D*mn
Alla	All*
Snot	Snot
wank	w*nk
Bast	B*st
rape	r*pe
homo	homo
crap	cr*p
quim	quim
Pohm	Pohm
Kunt	Kunt
bong	bong
dive	dive
Teat	Te*t
Hork	Hork
Geni	Geni
Mams	M*ms
geez	geez
gipp	gipp
Gypp	Gypp
jew	jew
Uck	Uck
jiz	jiz
gob	gob
Pud	Pud
sob	sob
God	God
sex	sex
Ass	Ass
pot	pot
Xxx	Xxx
Poo	Poo
dix	dix
nip	nip
Wog	Wog
kkk	kkk
nig	nig
Goy	Goy
gin	gin
poo	poo
Sob	Sob
Fuc	Fuc
Xtc	Xtc
wop	wop
Gay	G*y
pee	pee
Dix	Dix
Jew	Jew
wab	w*b
Mad	M*d
pud	pud
ero	ero
Sex	Sex
fat	f*t
hiv	hiv
Evl	Evl
jap	j*p
tnt	tnt
Tit	Tit
gun	gun
wtf	wtf
Pom	Pom
Lez	Lez
Gob	Gob
goy	goy
Fuk	Fuk
uck	uck
Fat	F*t
bra	br*
Tnt	Tnt
cum	cum
wog	wog
ass	*ss
Kkk	Kkk
Pee	Pee
Jap	J*p
Abo	Abo
Cum	Cum
Nip	Nip
sos	sos
pom	pom
xtc	xtc
tit	tit
Gyp	Gyp
fuk	fuk
evl	evl
xxx	xxx
Gun	Gun
Kid	Kid
fok	fok
mad	m*d
Sos	Sos
Fok	Fok
Gin	Gin
kum	kum
Fag	F*g
Wab	W*b
abo	*bo
die	die
kid	kid
gyp	gyp
Hiv	Hiv
lsd	lsd
gay	g*y
god	god
Nig	Nig
Bra	Br*
Jiz	Jiz
Pot	Pot
Wop	Wop
Kum	Kum
Lsd	Lsd
lez	lez
fag	f*g
Wtf	Wtf
fuc	fuc
Ero	Ero
Die	Die
uk	uk
wn	wn
ho	ho
ky	ky
Wn	Wn
Uk	Uk
fu	fu
Ky	Ky
bi	bi
Bi	Bi
Ho	Ho
Fu	Fu
