original	new
Gaymuthafuckinwhore	Gaym*thaf*ckinwhore
gaymuthafuckinwhore	gaym*thaf*ckinwhore
Goddamnmuthafucker	Goddamnm*thaf*cker
goddamnmuthafucker	goddamnm*thaf*cker
mattressprincess	mattressprincess
Mattressprincess	Mattressprincess
spaghettibender	spaghettibender
spaghettinigger	spaghettinigger
Spaghettibender	Spaghettibender
devilworshipper	devilworshipper
niggardliness's	niggardliness's
Spaghettinigger	Spaghettinigger
Devilworshipper	Devilworshipper
Niggardliness's	Niggardliness's
Motherfuckings	Motherf*ckings
Poorwhitetrash	Poorwhitetrash
spankthemonkey	spankthemonkey
smackthemonkey	smackthemonkey
purinapricness	p*rinapricness
Motherlovebone	Motherlovebone
Luckycammeltoe	L*ckycammeltoe
Purinapricness	P*rinapricness
motherfuckings	motherf*ckings
motherlovebone	motherlovebone
Spankthemonkey	Spankthemonkey
poorwhitetrash	poorwhitetrash
Smackthemonkey	Smackthemonkey
luckycammeltoe	l*ckycammeltoe
Alligatorbait	Alligatorbait
jacktheripper	jacktheripper
Tongethruster	Tongethr*ster
Carpetmuncher	Carpetm*ncher
shitforbrains	shitforbrains
fingerfucking	fingerf*cking
Motherfucking	Motherf*cking
pooperscooper	pooperscooper
Masterblaster	Masterblaster
dickforbrains	dickforbrains
Jacktheripper	Jacktheripper
Fingerfuckers	Fingerf*ckers
fingerfuckers	fingerf*ckers
Pooperscooper	Pooperscooper
Fingerfucking	Fingerf*cking
niggardliness	niggardliness
carpetmuncher	carpetm*ncher
virginbreaker	virginbreaker
Shitforbrains	Shitforbrains
pearlnecklace	pearlnecklace
Virginbreaker	Virginbreaker
Assassination	Assassination
shitoutofluck	shito*tofl*ck
Niggardliness	Niggardliness
assassination	assassination
tongethruster	tongethr*ster
Mothafuckings	Mothaf*ckings
mothafuckings	mothaf*ckings
Shitoutofluck	Shito*tofl*ck
masterblaster	masterblaster
alligatorbait	alligatorbait
Dickforbrains	Dickforbrains
motherfucking	motherf*cking
Pearlnecklace	Pearlnecklace
Pussypounder	P*ssypo*nder
Heterosexual	Heterosex*al
transvestite	transvestite
freakyfucker	freakyf*cker
Conservative	Conservative
masturbating	mast*rbating
Fingerfucked	Fingerf*cked
motherfucker	motherf*cker
Transvestite	Transvestite
Pornprincess	Pornprincess
pussypounder	p*ssypo*nder
pornprincess	pornprincess
Cherrypopper	Cherrypopper
motherfucked	motherf*cked
Mothafucking	Mothaf*cking
grostulation	grost*lation
Goldenshower	Goldenshower
fingerfucker	fingerf*cker
Fuckingbitch	F*ckingbitch
Titbitnipply	Titbitnipply
crotchmonkey	crotchmonkey
tunneloflove	t*nneloflove
Timbernigger	Timbernigger
Spermhearder	Spermhearder
Motherfuckin	Motherf*ckin
crotchjockey	crotchjockey
Trailertrash	Trailertrash
Motherfucker	Motherf*cker
Motherfucked	Motherf*cked
williewanker	williewanker
Fingerfucker	Fingerf*cker
fingerfucked	fingerf*cked
trailertrash	trailertrash
Tunneloflove	T*nneloflove
tonguethrust	tong*ethr*st
motherfuckin	motherf*ckin
Masturbating	Mast*rbating
Crotchmonkey	Crotchmonkey
butt-fuckers	b*tt-f*ckers
mothafucking	mothaf*cking
goldenshower	goldenshower
stupidfucker	st*pidf*cker
Freakyfucker	Freakyf*cker
Stupidfucker	St*pidf*cker
Lezbefriends	Lezbefriends
athletesfoot	athletesfoot
Williewanker	Williewanker
timbernigger	timbernigger
spermhearder	spermhearder
fuckingbitch	f*ckingbitch
Athletesfoot	Athletesfoot
nofuckingway	nof*ckingway
cherrypopper	cherrypopper
Crotchjockey	Crotchjockey
beatyourmeat	beatyo*rmeat
titbitnipply	titbitnipply
heterosexual	heterosex*al
Butt-fuckers	B*tt-f*ckers
lezbefriends	lezbefriends
Beatyourmeat	Beatyo*rmeat
Nofuckingway	Nof*ckingway
Tonguethrust	Tong*ethr*st
Grostulation	Grost*lation
conservative	conservative
crack-whore	crack-whore
sonofabitch	sonofabitch
Mothafuckaz	Mothaf*ckaz
Shithappens	Shithappens
doggiestyle	doggiestyle
Junglebunny	J*ngleb*nny
cuntlicking	c*ntlicking
Intercourse	Interco*rse
Twobitwhore	Twobitwhore
Fudgepacker	F*dgepacker
tonguetramp	tong*etramp
pussyfucker	p*ssyf*cker
homobangers	homobangers
mothafuckin	mothaf*ckin
Butt-fucker	B*tt-f*cker
Doggiestyle	Doggiestyle
mooncricket	mooncricket
Ejaculating	Ejac*lating
Fistfucking	Fistf*cking
Backdoorman	Backdoorman
Penetration	Penetration
Pussyfucker	P*ssyf*cker
executioner	exec*tioner
Crack-whore	Crack-whore
whiskeydick	whiskeydick
Whorefucker	Whoref*cker
junglebunny	j*ngleb*nny
Fuckinright	F*ckinright
spreadeagle	spreadeagle
Cunillingus	C*nilling*s
Holestuffer	Holest*ffer
Buttfuckers	B*ttf*ckers
ejaculation	ejac*lation
Cuntlicking	C*ntlicking
intercourse	interco*rse
Fannyfucker	Fannyf*cker
Pussylicker	P*ssylicker
porchmonkey	porchmonkey
Beastiality	Beastiality
snatchpatch	snatchpatch
kunnilingus	k*nniling*s
Mothafuckin	Mothaf*ckin
beastiality	beastiality
molestation	molestation
Whitenigger	Whitenigger
Molestation	Molestation
cyberslimer	cyberslimer
mothafucker	mothaf*cker
Buttmuncher	B*ttm*ncher
interracial	interracial
fistfucking	fistf*cking
fudgepacker	f*dgepacker
ejaculating	ejac*lating
whorefucker	whoref*cker
Kunnilingus	K*nniling*s
Spermherder	Spermherder
Cunnilingus	C*nniling*s
Tonguetramp	Tong*etramp
slimebucket	slimeb*cket
cockblocker	cockblocker
Slimebucket	Slimeb*cket
Snatchpatch	Snatchpatch
Whiskeydick	Whiskeydick
buttmuncher	b*ttm*ncher
Cameljockey	Cameljockey
Dingleberry	Dingleberry
Mastrabator	Mastrabator
Glazeddonut	Glazeddon*t
transsexual	transsex*al
Cockblocker	Cockblocker
shithappens	shithappens
cunnilingus	c*nniling*s
pussylicker	p*ssylicker
palestinian	palestinian
slavedriver	slavedriver
Meatbeatter	Meatbeatter
Executioner	Exec*tioner
twobitwhore	twobitwhore
Pornography	Pornography
butt-fucker	b*tt-f*cker
cocksucking	cocks*cking
Cocksucking	Cocks*cking
Breastlover	Breastlover
Ejaculation	Ejac*lation
pornography	pornography
cameljockey	cameljockey
whitenigger	whitenigger
Jesuschrist	Jes*schrist
Interracial	Interracial
spermherder	spermherder
jesuschrist	jes*schrist
cunillingus	c*nilling*s
Mothafucker	Mothaf*cker
dingleberry	dingleberry
mothafuckaz	mothaf*ckaz
Sonofabitch	Sonofabitch
Cyberslimer	Cyberslimer
Palestinian	Palestinian
skankybitch	skankybitch
barelylegal	barelylegal
mastrabator	mastrabator
Skankywhore	Skankywhore
meatbeatter	meatbeatter
Slavedriver	Slavedriver
fuckinright	f*ckinright
muffindiver	m*ffindiver
Skankybitch	Skankybitch
Transsexual	Transsex*al
penetration	penetration
buttfuckers	b*ttf*ckers
backdoorman	backdoorman
mothafucked	mothaf*cked
breastlover	breastlover
fannyfucker	fannyf*cker
Hillbillies	Hillbillies
assassinate	assassinate
Mothafucked	Mothaf*cked
Muffindiver	M*ffindiver
hillbillies	hillbillies
holestuffer	holest*ffer
Barelylegal	Barelylegal
Homobangers	Homobangers
Porchmonkey	Porchmonkey
glazeddonut	glazeddon*t
skankywhore	skankywhore
Assassinate	Assassinate
Mooncricket	Mooncricket
Spreadeagle	Spreadeagle
fingerfood	fingerfood
fuckmehard	f*ckmehard
Deepthroat	Deepthroat
Mothafucka	Mothaf*cka
Transexual	Transex*al
Footaction	Footaction
Lovemuscle	Lovem*scle
fingerfuck	fingerf*ck
fistfucked	fistf*cked
deapthroat	deapthroat
bumblefuck	b*mblef*ck
Motherfuck	Motherf*ck
Fuckmehard	F*ckmehard
nastybitch	nastybitch
footfucker	footf*cker
Loverocket	Loverocket
assblaster	assblaster
Snownigger	Snownigger
fuckinnuts	f*ckinn*ts
pickaninny	pickaninny
deepthroat	deepthroat
protestant	protestant
Butchbabes	B*tchbabes
bestiality	bestiality
assmuncher	assm*ncher
cuntfucker	c*ntf*cker
sandnigger	sandnigger
masturbate	mast*rbate
doggystyle	doggystyle
Niggarding	Niggarding
Doggystyle	Doggystyle
masterbate	masterbate
Sandnigger	Sandnigger
Masterbate	Masterbate
Mufflikcer	M*fflikcer
Cocksmoker	Cocksmoker
mufflikcer	m*fflikcer
footlicker	footlicker
Fourtwenty	Fo*rtwenty
Pocketpool	Pocketpool
flatulence	flat*lence
sixtyniner	sixtyniner
Shawtypimp	Shawtypimp
shawtypimp	shawtypimp
asspuppies	assp*ppies
samckdaddy	samckdaddy
children's	children's
sniggering	sniggering
Flatulence	Flat*lence
Lovepistol	Lovepistol
Palesimian	Palesimian
pussyeater	p*ssyeater
Headlights	Headlights
Bigbastard	Bigbastard
sleezeball	sleezeball
Fingerfuck	Fingerf*ck
greaseball	greaseball
lovemuscle	lovem*scle
suckmydick	s*ckmydick
Mickeyfinn	Mickeyfinn
republican	rep*blican
dicklicker	dicklicker
Sonofbitch	Sonofbitch
Balllicker	Balllicker
Propaganda	Propaganda
Beastality	Beastality
whiskydick	whiskydick
cocksmoker	cocksmoker
gangbanged	gangbanged
Gangbanged	Gangbanged
fourtwenty	fo*rtwenty
Bestiality	Bestiality
transexual	transex*al
propaganda	propaganda
facefucker	facef*cker
Fistfucker	Fistf*cker
Dicklicker	Dicklicker
kunilingus	k*niling*s
Cuntfucker	C*ntf*cker
Cocklicker	Cocklicker
pussylover	p*ssylover
Shitfucker	Shitf*cker
cocklicker	cocklicker
Suckmydick	S*ckmydick
peckerwood	peckerwood
Niggaracci	Niggaracci
Gangbanger	Gangbanger
mothafucka	mothaf*cka
Pussylover	P*ssylover
beastality	beastality
footaction	footaction
Homosexual	Homosex*al
Peckerwood	Peckerwood
snownigger	snownigger
nipplering	nipplering
Nastybitch	Nastybitch
Australian	A*stralian
gonorrehea	gonorrehea
pocketpool	pocketpool
Sixtyniner	Sixtyniner
cocksucker	cocks*cker
Whitetrash	Whitetrash
Footfucker	Footf*cker
Facefucker	Facef*cker
Sleezeball	Sleezeball
Cuntsucker	C*nts*cker
loverocket	loverocket
crackwhore	crackwhore
Stupidfuck	St*pidf*ck
Cuntlicker	C*ntlicker
stupidfuck	st*pidf*ck
Gonorrehea	Gonorrehea
Spermacide	Spermacide
cunilingus	c*niling*s
Unfuckable	Unf*ckable
prostitute	prostit*te
gangbanger	gangbanger
niggaracci	niggaracci
Fistfucked	Fistf*cked
nastywhore	nastywhore
Children's	Children's
skankbitch	skankbitch
conspiracy	conspiracy
corruption	corr*ption
Deapthroat	Deapthroat
sonofbitch	sonofbitch
Fuckinnuts	F*ckinn*ts
Skankbitch	Skankbitch
motherfuck	motherf*ck
cuntlicker	c*ntlicker
buttfucker	b*ttf*cker
Crackwhore	Crackwhore
clamdigger	clamdigger
shithapens	shithapens
Greaseball	Greaseball
australian	a*stralian
zipperhead	zipperhead
cockcowboy	cockcowboy
piccaninny	piccaninny
balllicker	balllicker
mickeyfinn	mickeyfinn
Assblaster	Assblaster
bigbastard	bigbastard
homosexual	homosex*al
Niggerhole	Niggerhole
Corruption	Corr*ption
cuntsucker	c*nts*cker
Chickslick	Chickslick
Fuckmonkey	F*ckmonkey
fuckfriend	f*ckfriend
Pussyeater	P*ssyeater
Protestant	Protestant
Prostitute	Prostit*te
Whorehouse	Whoreho*se
Cocksucked	Cocks*cked
whitetrash	whitetrash
mastabater	mastabater
Cunilingus	C*niling*s
niggerhole	niggerhole
cocksucked	cocks*cked
Masturbate	Mast*rbate
niggerhead	niggerhead
headlights	headlights
Buttpirate	B*ttpirate
Republican	Rep*blican
Kunilingus	K*niling*s
lovepistol	lovepistol
Nipplering	Nipplering
Conspiracy	Conspiracy
Piccaninny	Piccaninny
spermacide	spermacide
Niggerhead	Niggerhead
Zipperhead	Zipperhead
Shithapens	Shithapens
Sniggering	Sniggering
Fuckfriend	F*ckfriend
Skankwhore	Skankwhore
Clamdigger	Clamdigger
Buttfucker	B*ttf*cker
Mastabater	Mastabater
buttpirate	b*ttpirate
fuckmonkey	f*ckmonkey
chickslick	chickslick
niggarding	niggarding
fistfucker	fistf*cker
unfuckable	*nf*ckable
Cocksucker	Cocks*cker
Assmuncher	Assm*ncher
Bumblefuck	B*mblef*ck
Fingerfood	Fingerfood
Cockcowboy	Cockcowboy
shitfucker	shitf*cker
ejaculated	ejac*lated
Ejaculated	Ejac*lated
butchbabes	b*tchbabes
skankwhore	skankwhore
Nastywhore	Nastywhore
Asspuppies	Assp*ppies
Pickaninny	Pickaninny
Samckdaddy	Samckdaddy
whorehouse	whoreho*se
Footlicker	Footlicker
Whiskydick	Whiskydick
palesimian	palesimian
shortfuck	shortf*ck
cocksmith	cocksmith
Assfucker	Assf*cker
marijuana	marij*ana
butchdike	b*tchdike
Asslicker	Asslicker
pornflick	pornflick
cockblock	cockblock
Titfucker	Titf*cker
cumbubble	c*mb*bble
Slaughter	Sla*ghter
picaninny	picaninny
Sniggered	Sniggered
Rearentry	Rearentry
Breastjob	Breastjob
fuckfreak	f*ckfreak
fatfucker	fatf*cker
titfuckin	titf*ckin
disturbed	dist*rbed
Asscowboy	Asscowboy
cumjockey	c*mjockey
ethiopian	ethiopian
Marijuana	Marij*ana
Nigerians	Nigerians
assbagger	assbagger
fornicate	fornicate
upthebutt	*ptheb*tt
magicwand	magicwand
Feltching	Feltching
Shitfaced	Shitfaced
Loadedgun	Loadedg*n
Penthouse	Pentho*se
Sexy-slim	Sexy-slim
Analannie	Analannie
slideitin	slideitin
snigger's	snigger's
Suckmytit	S*ckmytit
Buttmunch	B*ttm*nch
Trisexual	Trisex*al
explosion	explosion
Assranger	Assranger
sweetness	sweetness
Cocklover	Cocklover
Goddamnit	Goddamnit
Stripclub	Stripcl*b
Magicwand	Magicwand
pimpjuice	pimpj*ice
Crackpipe	Crackpipe
buttstain	b*ttstain
Titlicker	Titlicker
Horseshit	Horseshit
bountybar	bo*ntybar
pussylips	p*ssylips
swallower	swallower
lovejuice	lovej*ice
Suckmyass	S*ckmyass
Shithouse	Shitho*se
Freakfuck	Freakf*ck
Primetime	Primetime
sniggered	sniggered
Ethiopian	Ethiopian
asscowboy	asscowboy
Buttstain	B*ttstain
execution	exec*tion
rearentry	rearentry
Asskisser	Asskisser
Ejaculate	Ejac*late
Dixiedyke	Dixiedyke
stripclub	stripcl*b
ejaculate	ejac*late
goddammit	goddammit
Slutwhore	Sl*twhore
hitlerist	hitlerist
Catholics	Catholics
Moneyshot	Moneyshot
asskisser	asskisser
skinflute	skinfl*te
testicles	testicles
slimeball	slimeball
Bootycall	Bootycall
dumbbitch	d*mbbitch
nigerians	nigerians
fuckbuddy	f*ckb*ddy
Cumjockey	C*mjockey
Sweetness	Sweetness
cockqueen	cockq*een
Cocktease	Cocktease
skankfuck	skankf*ck
pubiclice	p*biclice
Mastabate	Mastabate
asslicker	asslicker
prickhead	prickhead
Cockrider	Cockrider
mastabate	mastabate
Cigarette	Cigarette
clamdiver	clamdiver
Kumbullbe	K*mb*llbe
gatorbait	gatorbait
Nastyslut	Nastysl*t
Threesome	Threesome
niggardly	niggardly
Swallower	Swallower
niggarded	niggarded
criminals	criminals
penthouse	pentho*se
cocklover	cocklover
Sleezebag	Sleezebag
yellowman	yellowman
Clamdiver	Clamdiver
dixiedike	dixiedike
slaughter	sla*ghter
niggard's	niggard's
towelhead	towelhead
Fuckbuddy	F*ckb*ddy
primetime	primetime
feltching	feltching
goddamned	goddamned
bitchslap	bitchslap
nigglings	nigglings
slutwhore	sl*twhore
Fornicate	Fornicate
sexkitten	sexkitten
Premature	Premat*re
titlicker	titlicker
Dumbbitch	D*mbbitch
bi-sexual	bi-sex*al
assmonkey	assmonkey
Communist	Comm*nist
butt-fuck	b*tt-f*ck
Christian	Christian
Muffdiver	M*ffdiver
Mothafuck	Mothaf*ck
Fuckfreak	F*ckfreak
goddamnit	goddamnit
sixsixsix	sixsixsix
goddamnes	goddamnes
dickbrain	dickbrain
Testicles	Testicles
Butt-bang	B*tt-bang
kumbullbe	k*mb*llbe
shitfaced	shitfaced
Hitlerism	Hitlerism
Disturbed	Dist*rbed
damnation	damnation
Execution	Exec*tion
butchdyke	b*tchdyke
Niggardly	Niggardly
Terrorist	Terrorist
suckmytit	s*ckmytit
Fatfucker	Fatf*cker
Dragqueen	Dragq*een
asspacker	asspacker
Butchdyke	B*tchdyke
Dixiedike	Dixiedike
Dragqween	Dragqween
Towelhead	Towelhead
butt-bang	b*tt-bang
Assmonkey	Assmonkey
Bicurious	Bic*rio*s
assfucker	assf*cker
Splittail	Splittail
shitstain	shitstain
slopehead	slopehead
Explosion	Explosion
Asspacker	Asspacker
buttmunch	b*ttm*nch
cocktease	cocktease
Kumbubble	K*mb*bble
threesome	threesome
freakfuck	freakf*ck
Upthebutt	Uptheb*tt
sexy-slim	sexy-slim
Crotchrot	Crotchrot
Nigglings	Nigglings
Sixtynine	Sixtynine
asspirate	asspirate
cockrider	cockrider
Pornflick	Pornflick
Criminals	Criminals
premature	premat*re
dragqween	dragqween
Skinflute	Skinfl*te
Yellowman	Yellowman
Fuckwhore	F*ckwhore
splittail	splittail
Cockfight	Cockfight
Skankfuck	Skankf*ck
rentafuck	rentaf*ck
fuckwhore	f*ckwhore
Sexkitten	Sexkitten
Pimpjuice	Pimpj*ice
nutfucker	n*tf*cker
crotchrot	crotchrot
Butchdike	B*tchdike
Cockqueen	Cockq*een
hottotrot	hottotrot
Hijacking	Hijacking
Rentafuck	Rentaf*ck
Titfuckin	Titf*ckin
analannie	analannie
loadedgun	loadedg*n
cigarette	cigarette
Hitlerist	Hitlerist
scallywag	scallywag
moneyshot	moneyshot
shiteater	shiteater
Bi-sexual	Bi-sex*al
dragqueen	dragq*een
Cocksucer	Cocks*cer
Shitstain	Shitstain
Hottotrot	Hottotrot
excrement	excrement
christian	christian
breastjob	breastjob
cockfight	cockfight
Pubiclice	P*biclice
communist	comm*nist
Cockblock	Cockblock
suckmyass	s*ckmyass
hijacking	hijacking
mothafuck	mothaf*ck
titfucker	titf*cker
Pussylips	P*ssylips
Assbagger	Assbagger
Damnation	Damnation
sleezebag	sleezebag
bicurious	bic*rio*s
Bountybar	Bo*ntybar
Excrement	Excrement
horseshit	horseshit
Butt-fuck	B*tt-f*ck
Goddammit	Goddammit
assranger	assranger
catholics	catholics
shithouse	shitho*se
kumbubble	k*mb*bble
Cocksmith	Cocksmith
Picaninny	Picaninny
Prickhead	Prickhead
Cumbubble	C*mb*bble
Shortfuck	Shortf*ck
Nutfucker	N*tf*cker
Goddamned	Goddamned
Bitchslap	Bitchslap
Goddamnes	Goddamnes
hitlerism	hitlerism
cocksucer	cocks*cer
thicklips	thicklips
assjockey	assjockey
sixtynine	sixtynine
Inthebuff	Intheb*ff
breastman	breastman
Lovejuice	Lovej*ice
Scallywag	Scallywag
Asspirate	Asspirate
Niggard's	Niggard's
Slimeball	Slimeball
trisexual	trisex*al
inthebuff	intheb*ff
bootycall	bootycall
dixiedyke	dixiedyke
Gatorbait	Gatorbait
Dickbrain	Dickbrain
Thicklips	Thicklips
Sixsixsix	Sixsixsix
Shiteater	Shiteater
muffdiver	m*ffdiver
Slideitin	Slideitin
nastyslut	nastysl*t
Assjockey	Assjockey
Snigger's	Snigger's
Breastman	Breastman
Slopehead	Slopehead
crackpipe	crackpipe
Niggarded	Niggarded
terrorist	terrorist
narcotic	narcotic
Homicide	Homicide
Roundeye	Ro*ndeye
Headfuck	Headf*ck
Threeway	Threeway
hijacker	hijacker
Sniggers	Sniggers
cockknob	cockknob
homicide	homicide
lapdance	lapdance
cocktail	cocktail
diseases	diseases
Buttplug	B*ttpl*g
Felching	Felching
niggards	niggards
Phonesex	Phonesex
bullshit	b*llshit
testicle	testicle
murderer	m*rderer
ballsack	ballsack
freefuck	freef*ck
Footfuck	Footf*ck
cunteyed	c*nteyed
Foursome	Fo*rsome
screwyou	screwyo*
Abortion	Abortion
jackshit	jackshit
muffdive	m*ffdive
buttface	b*ttface
Fuckface	F*ckface
vibrator	vibrator
Copulate	Cop*late
niggling	niggling
sexhound	sexho*nd
Bullcrap	B*llcrap
jizjuice	jizj*ice
snowback	snowback
lovebone	lovebone
Filipino	Filipino
backseat	backseat
bisexual	bisex*al
coloured	colo*red
Eatpussy	Eatp*ssy
Butthead	B*tthead
fuckedup	f*cked*p
Horniest	Horniest
sniggers	sniggers
Retarded	Retarded
Shagging	Shagging
executed	exec*ted
sodomize	sodomize
cemetery	cemetery
Criminal	Criminal
Redlight	Redlight
playgirl	playgirl
Datnigga	Datnigga
Testicle	Testicle
Givehead	Givehead
barfface	barfface
Nigerian	Nigerian
filipina	filipina
sexhouse	sexho*se
Defecate	Defecate
Cockhead	Cockhead
datnigga	datnigga
Vietcong	Vietcong
shitface	shitface
roundeye	ro*ndeye
bunghole	b*nghole
chinamen	chinamen
chinaman	chinaman
Sodomise	Sodomise
bullcrap	b*llcrap
fuckfest	f*ckfest
Peepshow	Peepshow
manhater	manhater
clitoris	clitoris
Erection	Erection
Filipina	Filipina
Lapdance	Lapdance
Jackshit	Jackshit
Ballsack	Ballsack
thirdeye	thirdeye
Buttfuck	B*ttf*ck
sexually	sex*ally
Narcotic	Narcotic
Thirdeye	Thirdeye
dripdick	dripdick
dickless	dickless
Assholes	Assholes
Barfface	Barfface
Cocksuck	Cocks*ck
assmunch	assm*nch
Pussycat	P*ssycat
Uptheass	Uptheass
Thirdleg	Thirdleg
Knockers	Knockers
Fuckable	F*ckable
Slutwear	Sl*twear
Mosshead	Mosshead
spermbag	spermbag
Shitlist	Shitlist
footfuck	footf*ck
fuckface	f*ckface
retarded	retarded
Lovebone	Lovebone
foreskin	foreskin
Cunteyed	C*nteyed
minority	minority
blackout	blacko*t
Nigger's	Nigger's
Screwyou	Screwyo*
Sexhouse	Sexho*se
Bullshit	B*llshit
foursome	fo*rsome
stroking	stroking
Tuckahoe	T*ckahoe
sexwhore	sexwhore
Spigotty	Spigotty
buttbang	b*ttbang
footstar	footstar
syphilis	syphilis
swastika	swastika
Assassin	Assassin
canadian	canadian
gotohell	gotohell
abortion	abortion
Dickless	Dickless
assklown	assklown
Cumqueen	C*mq*een
pimpjuic	pimpj*ic
Arsehole	Arsehole
Sexhound	Sexho*nd
goddamit	goddamit
Bulldike	B*lldike
cocksman	cocksman
Fuckhead	F*ckhead
Assclown	Assclown
defecate	defecate
Cockknob	Cockknob
Stringer	Stringer
Dicklick	Dicklick
dicklick	dicklick
Coloured	Colo*red
easyslut	easysl*t
Canadian	Canadian
pornking	pornking
buggered	b*ggered
gonzagas	gonzagas
felching	felching
Suckdick	S*ckdick
Shitfull	Shitf*ll
Bisexual	Bisex*al
blackman	blackman
fellatio	fellatio
Jizjuice	Jizj*ice
Dumbfuck	D*mbf*ck
Cemetery	Cemetery
godammit	godammit
mosshead	mosshead
Cocktail	Cocktail
fuckknob	f*ckknob
Spermbag	Spermbag
Fucktard	F*cktard
molestor	molestor
shitdick	shitdick
Dickweed	Dickweed
Manpaste	Manpaste
Sodomite	Sodomite
beastial	beastial
Executed	Exec*ted
Vibrator	Vibrator
vibrater	vibrater
cockhead	cockhead
knockers	knockers
nigerian	nigerian
Muffdive	M*ffdive
molester	molester
Asswhore	Asswhore
hotpussy	hotp*ssy
Radicals	Radicals
Italiano	Italiano
Fuckfest	F*ckfest
shitlist	shitlist
vietcong	vietcong
phukking	ph*kking
Fuckedup	F*cked*p
european	e*ropean
Sodomize	Sodomize
Buggered	B*ggered
Chinaman	Chinaman
nigger's	nigger's
Gotohell	Gotohell
Diseases	Diseases
Easyslut	Easysl*t
Slanteye	Slanteye
slanteye	slanteye
shagging	shagging
lingerie	lingerie
Jijjiboo	Jijjiboo
Sexwhore	Sexwhore
violence	violence
Shitting	Shitting
bulldike	b*lldike
Minority	Minority
Blackout	Blacko*t
shitfuck	shitf*ck
pimpsimp	pimpsimp
Lingerie	Lingerie
Assmunch	Assm*nch
Dipstick	Dipstick
Dickhead	Dickhead
Feltcher	Feltcher
Bulldyke	B*lldyke
threeway	threeway
Sexymoma	Sexymoma
Godammit	Godammit
Fuckknob	F*ckknob
erection	erection
pussycat	p*ssycat
Swastika	Swastika
slutwear	sl*twear
Titlover	Titlover
cuntlick	c*ntlick
shitfull	shitf*ll
Foreskin	Foreskin
cybersex	cybersex
Clitoris	Clitoris
Limpdick	Limpdick
Phukking	Ph*kking
cornhole	cornhole
Gangbang	Gangbang
meatrack	meatrack
Japanese	Japanese
Fistfuck	Fistf*ck
Buttbang	B*ttbang
buttfuck	b*ttf*ck
Violence	Violence
Murderer	M*rderer
Bunghole	B*nghole
fucktard	f*cktard
European	E*ropean
cuntfuck	c*ntf*ck
Shooting	Shooting
beat-off	beat-off
givehead	givehead
japanese	japanese
Asslover	Asslover
Shithead	Shithead
Cornhole	Cornhole
Assklown	Assklown
ontherag	ontherag
showtime	showtime
tuckahoe	t*ckahoe
israel's	israel's
spigotty	spigotty
suckdick	s*ckdick
fuckhead	f*ckhead
Sexually	Sex*ally
criminal	criminal
headfuck	headf*ck
Shitface	Shitface
Shitdick	Shitdick
Ontherag	Ontherag
Niggards	Niggards
Beat-off	Beat-off
intheass	intheass
sodomite	sodomite
sodomise	sodomise
sexymoma	sexymoma
Footstar	Footstar
Intheass	Intheass
Beastial	Beastial
butthead	b*tthead
Pimpsimp	Pimpsimp
phonesex	phonesex
Hijacker	Hijacker
Fastfuck	Fastf*ck
Showtime	Showtime
asslover	asslover
Pimpjuic	Pimpj*ic
Goddamit	Goddamit
Pisshead	Pisshead
shithead	shithead
jijjiboo	jijjiboo
Pornking	Pornking
Chinamen	Chinamen
dumbfuck	d*mbf*ck
uptheass	*ptheass
gangbang	gangbang
Manhater	Manhater
filipino	filipino
Henhouse	Henho*se
Gonzagas	Gonzagas
american	american
titlover	titlover
Bitching	Bitching
Molester	Molester
eatballs	eatballs
eatpussy	eatp*ssy
dipstick	dipstick
Playgirl	Playgirl
Sexslave	Sexslave
shooting	shooting
Vibrater	Vibrater
Dripdick	Dripdick
radicals	radicals
Cuntfuck	C*ntf*ck
asswhore	asswhore
poontang	poontang
cumqueen	c*mq*een
Snowback	Snowback
assclown	assclown
Slutting	Sl*tting
pisshead	pisshead
Cocksman	Cocksman
Fellatio	Fellatio
bazongas	bazongas
Cameltoe	Cameltoe
Hotpussy	Hotp*ssy
American	American
assassin	assassin
Bazongas	Bazongas
cocksuck	cocks*ck
henhouse	henho*se
sexslave	sexslave
backdoor	backdoor
Backseat	Backseat
bulldyke	b*lldyke
Catholic	Catholic
Shitfuck	Shitf*ck
Blackman	Blackman
Backdoor	Backdoor
assholes	assholes
thirdleg	thirdleg
Syphilis	Syphilis
Poontang	Poontang
buttplug	b*ttpl*g
manpaste	manpaste
cameltoe	cameltoe
Niggling	Niggling
slutting	sl*tting
arsehole	arsehole
bitching	bitching
stringer	stringer
dickweed	dickweed
peepshow	peepshow
redlight	redlight
limpdick	limpdick
Buttface	B*ttface
Peepshpw	Peepshpw
fuckable	f*ckable
Cuntlick	C*ntlick
fastfuck	fastf*ck
feltcher	feltcher
Molestor	Molestor
copulate	cop*late
Eatballs	Eatballs
fistfuck	fistf*ck
Stroking	Stroking
Freefuck	Freef*ck
Israel's	Israel's
peepshpw	peepshpw
italiano	italiano
Meatrack	Meatrack
Cybersex	Cybersex
horniest	horniest
shitting	shitting
catholic	catholic
dickhead	dickhead
poverty	poverty
cumshot	c*mshot
colored	colored
bitchez	bitchez
Lesbain	Lesbain
Reestie	Reestie
lesbian	lesbian
drunken	dr*nken
pooping	pooping
Bombing	Bombing
hotdamn	hotdamn
negro's	negro's
Lucifer	L*cifer
Bastard	Bastard
Lovegoo	Lovegoo
Suicide	S*icide
dumbass	d*mbass
fagging	fagging
jiggabo	jiggabo
sexfarm	sexfarm
Mulatto	M*latto
niggard	niggard
Peehole	Peehole
Genital	Genital
Shitter	Shitter
Bitcher	Bitcher
Funfuck	F*nf*ck
lucifer	l*cifer
japcrap	japcrap
Pissing	Pissing
liberal	liberal
Urinary	Urinary
juggalo	j*ggalo
welfare	welfare
Liberal	Liberal
Torture	Tort*re
Whigger	Whigger
Pindick	Pindick
Quashie	Q*ashie
quashie	q*ashie
Phuking	Ph*king
asshole	asshole
Quickie	Q*ickie
bastard	bastard
Felatio	Felatio
Wetback	Wetback
snigger	snigger
Sheeney	Sheeney
urinary	*rinary
Hotdamn	Hotdamn
Felcher	Felcher
Dipshit	Dipshit
negroes	negroes
titfuck	titf*ck
whigger	whigger
Bollock	Bollock
Servant	Servant
Fuckers	F*ckers
Amateur	Amate*r
Swallow	Swallow
Jerkoff	Jerkoff
Welcher	Welcher
Cumming	C*mming
Pissoff	Pissoff
killing	killing
pussies	p*ssies
fuckbag	f*ckbag
servant	servant
Fairies	Fairies
assault	assa*lt
Pansies	Pansies
pissing	pissing
Bumfuck	B*mf*ck
Assault	Assa*lt
niggers	niggers
Dickman	Dickman
Puddboy	P*ddboy
baptist	baptist
Cumquat	C*mq*at
lesbayn	lesbayn
Buggery	B*ggery
jackass	jackass
Analsex	Analsex
Panties	Panties
Twinkie	Twinkie
urinate	*rinate
Radical	Radical
Rimming	Rimming
skumbag	sk*mbag
Disease	Disease
negroid	negroid
Bondage	Bondage
bumfuck	b*mf*ck
Vaginal	Vaginal
carruth	carr*th
analsex	analsex
Shitcan	Shitcan
mulatto	m*latto
swallow	swallow
rearend	rearend
Shitola	Shitola
Goddamn	Goddamn
remains	remains
Refugee	Ref*gee
Lactate	Lactate
Kumming	K*mming
Jigaboo	Jigaboo
lovegun	loveg*n
rimming	rimming
Colored	Colored
Shiting	Shiting
Crapper	Crapper
dickwad	dickwad
niggles	niggles
Redneck	Redneck
goddamn	goddamn
asshore	asshore
tarbaby	tarbaby
buggery	b*ggery
whacker	whacker
Bitchez	Bitchez
Triplex	Triplex
Fuckbag	F*ckbag
strapon	strapon
niggled	niggled
amateur	amate*r
shitted	shitted
gangsta	gangsta
Baptist	Baptist
muncher	m*ncher
Fuckina	F*ckina
Shaggin	Shaggin
triplex	triplex
Jiggabo	Jiggabo
honkers	honkers
cocaine	cocaine
Beatoff	Beatoff
Russkie	R*sskie
dipshit	dipshit
Asslick	Asslick
badfuck	badf*ck
Farting	Farting
mexican	mexican
Coondog	Coondog
genital	genital
torture	tort*re
Fisting	Fisting
russkie	r*sskie
disease	disease
suicide	s*icide
bollick	bollick
lesbain	lesbain
Fuckyou	F*ckyo*
Wetspot	Wetspot
shitfit	shitfit
Clogwog	Clogwog
bitchin	bitchin
Trannie	Trannie
boobies	boobies
Mexican	Mexican
kumming	k*mming
puddboy	p*ddboy
kumquat	k*mq*at
barface	barface
Juggalo	J*ggalo
israeli	israeli
Barface	Barface
Nastyho	Nastyho
Penises	Penises
reestie	reestie
phukked	ph*kked
Spitter	Spitter
pansies	pansies
Cocaine	Cocaine
Illegal	Illegal
Vatican	Vatican
Honkers	Honkers
Execute	Exec*te
asswipe	asswipe
slapper	slapper
Suckoff	S*ckoff
clogwog	clogwog
Asshore	Asshore
fuckers	f*ckers
Shinola	Shinola
Hooters	Hooters
Negroes	Negroes
quickie	q*ickie
Sextoys	Sextoys
Fagging	Fagging
penises	penises
Urinate	Urinate
lowlife	lowlife
Israeli	Israeli
Cumshot	C*mshot
Strapon	Strapon
welcher	welcher
Niggles	Niggles
kissass	kissass
Drunken	Dr*nken
shiting	shiting
Lovegun	Loveg*n
Lubejob	L*bejob
Titties	Titties
Fuckoff	F*ckoff
titties	titties
Gangsta	Gangsta
wanking	wanking
phuking	ph*king
bondage	bondage
bigbutt	bigb*tt
fuckyou	f*ckyo*
Lesbian	Lesbian
shinola	shinola
bitcher	bitcher
handjob	handjob
doo-doo	doo-doo
funeral	f*neral
Orgasim	Orgasim
Fatfuck	Fatf*ck
sextogo	sextogo
Snigger	Snigger
Blowjob	Blowjob
Wanking	Wanking
pindick	pindick
Kumquat	K*mq*at
Hiscock	Hiscock
Welfare	Welfare
Bitchin	Bitchin
Funeral	F*neral
Brothel	Brothel
brothel	brothel
Carruth	Carr*th
bollock	bollock
Addicts	Addicts
Jackoff	Jackoff
orgasim	orgasim
Tarbaby	Tarbaby
assfuck	assf*ck
jigaboo	jigaboo
hosejob	hosejob
Niggard	Niggard
Buttman	B*ttman
Rearend	Rearend
Hosejob	Hosejob
playboy	playboy
mideast	mideast
puntang	p*ntang
phungky	ph*ngky
Deposit	Deposit
Skumbag	Sk*mbag
bitches	bitches
Schlong	Schlong
Bestial	Bestial
Hookers	Hookers
Remains	Remains
shaggin	shaggin
spitter	spitter
livesex	livesex
Muncher	M*ncher
Livesex	Livesex
Whiskey	Whiskey
scrotum	scrot*m
jimfish	jimfish
Aroused	Aro*sed
Jimfish	Jimfish
asslick	asslick
Lesbayn	Lesbayn
Ecstacy	Ecstacy
Pussies	P*ssies
Pooping	Pooping
ecstacy	ecstacy
Lowlife	Lowlife
trannie	trannie
women's	women's
Jackass	Jackass
Pee-pee	Pee-pee
vatican	vatican
Slapper	Slapper
asskiss	asskiss
Niggers	Niggers
Asshole	Asshole
Fuckher	F*ckher
Puntang	P*ntang
fairies	fairies
cumming	c*mming
addicts	addicts
cumquat	c*mq*at
Kissass	Kissass
whiskey	whiskey
jackoff	jackoff
Hostage	Hostage
illegal	illegal
fucking	f*cking
hostage	hostage
shitter	shitter
cumfest	c*mfest
Whacker	Whacker
crapper	crapper
Boobies	Boobies
sheeney	sheeney
pissoff	pissoff
schlong	schlong
bombing	bombing
fuckina	f*ckina
chinese	chinese
Cumfest	C*mfest
fuckoff	f*ckoff
getiton	getiton
Niggled	Niggled
waysted	waysted
Mideast	Mideast
hooters	hooters
lovegoo	lovegoo
bestial	bestial
Banging	Banging
Phukked	Ph*kked
Cocknob	Cocknob
Dumbass	D*mbass
bombers	bombers
Handjob	Handjob
Women's	Women's
Raghead	Raghead
hustler	h*stler
Waysted	Waysted
bazooms	bazooms
dickman	dickman
Titfuck	Titf*ck
Badfuck	Badf*ck
sextoys	sextoys
raghead	raghead
Bazooms	Bazooms
Bollick	Bollick
Playboy	Playboy
wetspot	wetspot
vaginal	vaginal
twinkie	twinkie
Sexfarm	Sexfarm
Shitfit	Shitfit
coondog	coondog
Phungky	Ph*ngky
African	African
hookers	hookers
blowjob	blowjob
Negro's	Negro's
felatio	felatio
nastyho	nastyho
deposit	deposit
Bombers	Bombers
panties	panties
fatfuck	fatf*ck
felcher	felcher
aroused	aro*sed
Asskiss	Asskiss
Shitted	Shitted
Negroid	Negroid
Chinese	Chinese
redneck	redneck
Scrotum	Scrot*m
fuckher	f*ckher
Bitches	Bitches
Getiton	Getiton
funfuck	f*nf*ck
upskirt	*pskirt
jerkoff	jerkoff
Destroy	Destroy
Fucking	F*cking
shitola	shitola
fisting	fisting
Killing	Killing
refugee	ref*gee
lactate	lactate
beatoff	beatoff
shitcan	shitcan
Poverty	Poverty
failure	fail*re
Bigbutt	Bigb*tt
lubejob	l*bejob
Fuckpig	F*ckpig
suckoff	s*ckoff
pee-pee	pee-pee
execute	exec*te
wetback	wetback
african	african
Asswipe	Asswipe
Hustler	H*stler
farting	farting
radical	radical
peehole	peehole
destroy	destroy
cocknob	cocknob
flasher	flasher
Japcrap	Japcrap
buttman	b*ttman
Failure	Fail*re
Dickwad	Dickwad
crapola	crapola
hiscock	hiscock
banging	banging
Doo-doo	Doo-doo
Crapola	Crapola
Assfuck	Assf*ck
Flasher	Flasher
Sextogo	Sextogo
fuckpig	f*ckpig
Upskirt	Upskirt
Areola	Areola
Racial	Racial
escort	escort
pistol	pistol
Tortur	Tort*r
nookie	nookie
Gyppie	Gyppie
krappy	krappy
Babies	Babies
robber	robber
Africa	Africa
Nooner	Nooner
Incest	Incest
nudger	n*dger
fuckit	f*ckit
chinky	chinky
Failed	Failed
Tittie	Tittie
Slopey	Slopey
Kanake	Kanake
Iblowu	Iblow*
Gringo	Gringo
pommie	pommie
Pooper	Pooper
Hummer	H*mmer
Tantra	Tantra
moslem	moslem
firing	firing
shited	shited
retard	retard
kondum	kond*m
Noonan	Noonan
dammit	dammit
Toilet	Toilet
mockie	mockie
rectum	rect*m
weapon	weapon
Zigabo	Zigabo
pisser	pisser
pecker	pecker
Tosser	Tosser
feltch	feltch
Escort	Escort
niggor	niggor
Nudger	N*dger
sniper	sniper
Darkie	Darkie
kigger	kigger
period	period
Kigger	Kigger
gringo	gringo
killed	killed
nittit	nittit
Swalow	Swalow
Wanker	Wanker
tortur	tort*r
darkie	darkie
Weenie	Weenie
Farted	Farted
Fister	Fister
soviet	soviet
spunky	sp*nky
hitler	hitler
suckme	s*ckme
dahmer	dahmer
Sucker	S*cker
Rapist	Rapist
turnon	t*rnon
Hijack	Hijack
gummer	g*mmer
bigger	bigger
hooker	hooker
Pudboy	P*dboy
skanky	skanky
Jizzum	Jizz*m
Dahmer	Dahmer
stiffy	stiffy
Mormon	Mormon
crappy	crappy
Pimped	Pimped
Wigger	Wigger
horney	horney
Tampon	Tampon
flydye	flydye
reefer	reefer
Orgasm	Orgasm
Turnon	T*rnon
Slutty	Sl*tty
diddle	diddle
Feltch	Feltch
willie	willie
creamy	creamy
liquor	liq*or
Israel	Israel
whitey	whitey
honger	honger
Titjob	Titjob
niggur	nigg*r
Rectum	Rect*m
Nignog	Nignog
Attack	Attack
faggot	faggot
wanker	wanker
Commie	Commie
Stroke	Stroke
Christ	Christ
Period	Period
Condom	Condom
Liquor	Liq*or
Addict	Addict
sexpot	sexpot
Hodgie	Hodgie
bugger	b*gger
Vagina	Vagina
Reefer	Reefer
slutty	sl*tty
Creamy	Creamy
popimp	popimp
Looser	Looser
coitus	coit*s
titjob	titjob
Hooker	Hooker
Chinky	Chinky
breast	breast
Sexpot	Sexpot
Nookie	Nookie
Phuked	Ph*ked
insest	insest
orgasm	orgasm
Krappy	Krappy
pisses	pisses
Tranny	Tranny
faeces	faeces
yankee	yankee
Molest	Molest
farted	farted
sucker	s*cker
beaver	beaver
Racist	Racist
Assman	Assman
virgin	virgin
Asshat	Asshat
Geezer	Geezer
tosser	tosser
jigger	jigger
kaffir	kaffir
Orgies	Orgies
Cacker	Cacker
herpes	herpes
iblowu	iblow*
biatch	biatch
Pissed	Pissed
blacks	blacks
Mockie	Mockie
Lotion	Lotion
pissed	pissed
toilet	toilet
Killed	Killed
Hitler	Hitler
Nigger	Nigger
dyefly	dyefly
polack	polack
reject	reject
Kaffre	Kaffre
looser	looser
Niggle	Niggle
hummer	h*mmer
sextoy	sextoy
Tinkle	Tinkle
fckcum	fckc*m
Dyefly	Dyefly
Fuckin	F*ckin
Licker	Licker
Gaysex	Gaysex
Fondle	Fondle
cacker	cacker
Uterus	Uter*s
racist	racist
killer	killer
Damnit	Damnit
Sexual	Sex*al
weenie	weenie
pimped	pimped
Fungus	F*ng*s
Fuckme	F*ckme
noonan	noonan
German	German
Nookey	Nookey
terror	terror
kanake	kanake
Fucked	F*cked
fuckin	f*ckin
Niggur	Nigg*r
tinkle	tinkle
Sniper	Sniper
nooner	nooner
honkey	honkey
Ethnic	Ethnic
Pisses	Pisses
Diddle	Diddle
molest	molest
byatch	byatch
nipple	nipple
sexing	sexing
Bugger	B*gger
Reject	Reject
fucked	f*cked
Weewee	Weewee
Coitus	Coit*s
Fetish	Fetish
lotion	lotion
fatass	fatass
Flange	Flange
tittie	tittie
Pissin	Pissin
Robber	Robber
doodoo	doodoo
Willie	Willie
babies	babies
pimper	pimper
stupid	st*pid
jizzim	jizzim
licker	licker
Pistol	Pistol
Pisser	Pisser
commie	commie
attack	attack
hindoo	hindoo
Ribbed	Ribbed
Gummer	G*mmer
Rimjob	Rimjob
Hardon	Hardon
Polack	Polack
Boonie	Boonie
Retard	Retard
Stiffy	Stiffy
sodomy	sodomy
flange	flange
Niggah	Niggah
lesbin	lesbin
Niglet	Niglet
zigabo	zigabo
Fatass	Fatass
biteme	biteme
Libido	Libido
Macaca	Macaca
nlggor	nlggor
Boonga	Boonga
hardon	hardon
gaysex	gaysex
addict	addict
muslim	m*slim
Niggaz	Niggaz
Lolita	Lolita
Cunntt	C*nntt
cummer	c*mmer
fuckme	f*ckme
coolie	coolie
Murder	M*rder
hijack	hijack
Weapon	Weapon
kummer	k*mmer
Heroin	Heroin
desire	desire
Nlgger	Nlgger
Crappy	Crappy
Spooge	Spooge
rapist	rapist
Virgin	Virgin
areola	areola
libido	libido
Desire	Desire
Spunky	Sp*nky
Bitchy	Bitchy
fucker	f*cker
kaffre	kaffre
Snatch	Snatch
swalow	swalow
Nlggor	Nlggor
kaffer	kaffer
Suckme	S*ckme
tantra	tantra
Faggot	Faggot
tampon	tampon
wigger	wigger
Beaner	Beaner
Bigass	Bigass
Harder	Harder
Honkey	Honkey
russki	r*sski
Pecker	Pecker
condom	condom
christ	christ
Beaver	Beaver
Crotch	Crotch
Pimper	Pimper
Biatch	Biatch
pussie	p*ssie
Breast	Breast
boonga	boonga
Cancer	Cancer
Pussie	P*ssie
Mockey	Mockey
Killer	Killer
Jigger	Jigger
lickme	lickme
Whites	Whites
german	german
Horney	Horney
israel	israel
Muslim	M*slim
ethnic	ethnic
Hindoo	Hindoo
Fucker	F*cker
snatch	snatch
racial	racial
buried	b*ried
brea5t	brea5t
Doodoo	Doodoo
Niggor	Niggor
mormon	mormon
Faeces	Faeces
tranny	tranny
Lesbin	Lesbin
bohunk	boh*nk
Yankee	Yankee
Wuzzie	W*zzie
vagina	vagina
Shited	Shited
nignog	nignog
Fckcum	Fckc*m
lolita	lolita
nigger	nigger
niglet	niglet
Insest	Insest
Cummer	C*mmer
church	ch*rch
Flydye	Flydye
asshat	asshat
Trojan	Trojan
Sexing	Sexing
crimes	crimes
Russki	R*sski
mockey	mockey
crotch	crotch
Blacks	Blacks
Herpes	Herpes
Honger	Honger
Fuckit	F*ckit
hodgie	hodgie
Sodomy	Sodomy
Nittit	Nittit
heroin	heroin
Church	Ch*rch
Buried	B*ried
Shitty	Shitty
fungus	f*ng*s
wuzzie	w*zzie
rigger	rigger
Coolie	Coolie
damnit	damnit
Kaffir	Kaffir
orgies	orgies
Penile	Penile
rimjob	rimjob
trojan	trojan
penile	penile
Kaffer	Kaffer
shitty	shitty
Whitey	Whitey
fister	fister
Popimp	Popimp
Stupid	St*pid
phuked	ph*ked
jizzum	jizz*m
niggle	niggle
sexual	sex*al
macaca	macaca
Firing	Firing
beaner	beaner
jewish	jewish
Sextoy	Sextoy
ribbed	ribbed
geezer	geezer
tongue	tong*e
murder	m*rder
boonie	boonie
Lickme	Lickme
Tongue	Tong*e
Kummer	K*mmer
Jewish	Jewish
Flydie	Flydie
nookey	nookey
niggah	niggah
incest	incest
whites	whites
Nipple	Nipple
africa	africa
Moslem	Moslem
Kondum	Kond*m
Terror	Terror
bigass	bigass
weewee	weewee
Soviet	Soviet
niggaz	niggaz
failed	failed
Pommie	Pommie
Crimes	Crimes
nlgger	nlgger
Biteme	Biteme
fetish	fetish
Bigger	Bigger
uterus	*ter*s
slopey	slopey
Dammit	Dammit
Rigger	Rigger
cancer	cancer
Skanky	Skanky
Brea5t	Brea5t
Byatch	Byatch
spooge	spooge
pissin	pissin
cunntt	c*nntt
pooper	pooper
Bohunk	Boh*nk
assman	assman
pudboy	p*dboy
gyppie	gyppie
bitchy	bitchy
Jizzim	Jizzim
fondle	fondle
harder	harder
stroke	stroke
flydie	flydie
bogan	bogan
booby	booby
darky	darky
Taboo	Taboo
loser	loser
Moron	Moron
kills	kills
Moles	Moles
Devil	Devil
hoser	hoser
Pixie	Pixie
faith	faith
enemy	enemy
Lynch	Lynch
Roach	Roach
Piker	Piker
Forni	Forni
bible	bible
negro	negro
balls	balls
ginzo	ginzo
Smack	Smack
sooty	sooty
Titty	Titty
Porno	Porno
Vulva	V*lva
fatah	fatah
urine	*rine
cooly	cooly
Dildo	Dildo
Teste	Teste
Slave	Slave
fucks	f*cks
Crabs	Crabs
Rabbi	Rabbi
fight	fight
Loser	Loser
Negro	Negro
pixie	pixie
Fraud	Fra*d
Boobs	Boobs
Girls	Girls
Boody	Boody
Fubar	F*bar
Chode	Chode
Fight	Fight
moron	moron
fraud	fra*d
Pocho	Pocho
lezbo	lezbo
Honky	Honky
gross	gross
Idiot	Idiot
boang	boang
beast	beast
sexed	sexed
Sandm	Sandm
choad	choad
kotex	kotex
shits	shits
panti	panti
Semen	Semen
shite	shite
screw	screw
Death	Death
Asian	Asian
Pikey	Pikey
sandm	sandm
fucck	f*cck
Angie	Angie
pu55y	p*55y
crash	crash
Whash	Whash
trots	trots
niger	niger
black	black
slopy	slopy
fagot	fagot
naked	naked
Raped	Raped
taboo	taboo
bombs	bombs
Gyppo	Gyppo
feces	feces
whash	whash
Boang	Boang
Color	Color
usama	*sama
Latin	Latin
Ginzo	Ginzo
Hymie	Hymie
mgger	mgger
Harem	Harem
Kafir	Kafir
Whore	Whore
Kraut	Kra*t
shhit	shhit
lezzo	lezzo
Drunk	Dr*nk
Naked	Naked
fugly	f*gly
enema	enema
Hamas	Hamas
Slant	Slant
abuse	ab*se
Spank	Spank
goyim	goyim
slutt	sl*tt
Hoser	Hoser
Spunk	Sp*nk
cra5h	cra5h
sissy	sissy
hamas	hamas
Lesbo	Lesbo
lynch	lynch
Sodom	Sodom
Slutt	Sl*tt
hussy	h*ssy
Necro	Necro
Nymph	Nymph
Sperm	Sperm
raped	raped
Shits	Shits
Cohee	Cohee
Fugly	F*gly
boody	boody
Husky	H*sky
boobs	boobs
Fuuck	F**ck
mggor	mggor
Angry	Angry
Fairy	Fairy
Usama	Usama
piker	piker
Nigga	Nigga
Goyim	Goyim
chode	chode
Raper	Raper
Vomit	Vomit
pocho	pocho
Shite	Shite
stagg	stagg
Willy	Willy
gubba	g*bba
Lugan	L*gan
mafia	mafia
slave	slave
pansy	pansy
Spick	Spick
Cooly	Cooly
dirty	dirty
Pussy	P*ssy
semen	semen
pendy	pendy
Stagg	Stagg
lezbe	lezbe
Fucck	F*cck
Pubic	P*bic
queef	q*eef
Lezbo	Lezbo
Pendy	Pendy
Felch	Felch
Penis	Penis
Eatme	Eatme
Sadis	Sadis
Horny	Horny
husky	h*sky
Enemy	Enemy
spick	spick
Sadom	Sadom
girls	girls
Crash	Crash
harem	harem
Arabs	Arabs
fatso	fatso
Screw	Screw
Gyppy	Gyppy
Lezbe	Lezbe
jebus	jeb*s
Jizim	Jizim
Booty	Booty
jiggy	jiggy
Urine	Urine
Fatso	Fatso
jesus	jes*s
Boong	Boong
Abuse	Ab*se
Fucka	F*cka
jigga	jigga
Farty	Farty
Mocky	Mocky
nigga	nigga
willy	willy
Queef	Q*eef
osama	osama
sodom	sodom
horny	horny
Seppo	Seppo
arabs	arabs
Kills	Kills
tramp	tramp
raper	raper
Feces	Feces
twink	twink
pommy	pommy
Nasty	Nasty
spunk	sp*nk
vulva	v*lva
spank	spank
Queer	Q*eer
Beast	Beast
Randy	Randy
squaw	sq*aw
Choad	Choad
boner	boner
asian	asian
hymie	hymie
penis	penis
Jigga	Jigga
fucka	f*cka
Sissy	Sissy
Allah	Allah
bitch	bitch
Fucks	F*cks
Fatah	Fatah
Tramp	Tramp
color	color
kinky	kinky
Hymen	Hymen
Black	Black
Fagot	Fagot
kafir	kafir
adult	ad*lt
Nigre	Nigre
skank	skank
angie	angie
Pu55i	P*55i
lugan	l*gan
Slopy	Slopy
Bogan	Bogan
Mggor	Mggor
Pu55y	P*55y
crime	crime
Knife	Knife
felch	felch
drunk	dr*nk
cocky	cocky
smack	smack
demon	demon
seppo	seppo
Kinky	Kinky
kraut	kra*t
sadis	sadis
Cra5h	Cra5h
sadom	sadom
allah	allah
Trots	Trots
fubar	f*bar
peni5	peni5
pu55i	p*55i
whore	whore
Peni5	Peni5
Bombs	Bombs
Lezzo	Lezzo
teste	teste
roach	roach
joint	joint
eatme	eatme
Bunga	B*nga
dildo	dildo
hymen	hymen
Shoot	Shoot
angry	angry
Sluts	Sl*ts
Pommy	Pommy
farty	farty
fuuck	f**ck
death	death
vomit	vomit
Shhit	Shhit
argie	argie
Twink	Twink
Panti	Panti
jizim	jizim
pikey	pikey
Cocky	Cocky
Sexed	Sexed
slime	slime
Nigra	Nigra
Booby	Booby
Joint	Joint
nigra	nigra
crabs	crabs
crack	crack
porno	porno
Argie	Argie
knife	knife
Chink	Chink
Blind	Blind
Crack	Crack
Kotex	Kotex
Crime	Crime
Squaw	Sq*aw
Prick	Prick
pocha	pocha
nasty	nasty
nigre	nigre
gyppy	gyppy
Erect	Erect
Jebus	Jeb*s
Demon	Demon
queer	q*eer
Niger	Niger
bunga	b*nga
pussy	p*ssy
randy	randy
Enema	Enema
Gross	Gross
Limey	Limey
fairy	fairy
Balls	Balls
rabbi	rabbi
honky	honky
Jiggy	Jiggy
forni	forni
slant	slant
boong	boong
Asses	Asses
Bible	Bible
Mafia	Mafia
mocky	mocky
moles	moles
Jesus	Jes*s
Dirty	Dirty
asses	asses
limey	limey
Gubba	G*bba
Darky	Darky
Pocha	Pocha
prick	prick
idiot	idiot
Bitch	Bitch
erect	erect
jihad	jihad
Hussy	H*ssy
Faith	Faith
titty	titty
Satan	Satan
devil	devil
blind	blind
necro	necro
Slime	Slime
Osama	Osama
satan	satan
booty	booty
pubic	p*bic
Adult	Ad*lt
sluts	sl*ts
cohee	cohee
gyppo	gyppo
latin	latin
Boner	Boner
Jihad	Jihad
Pansy	Pansy
Skank	Skank
Mgger	Mgger
Sooty	Sooty
shoot	shoot
sperm	sperm
nymph	nymph
lesbo	lesbo
chink	chink
ikey	ikey
jigg	jigg
bomd	bomd
Hell	Hell
Paki	Paki
Skum	Sk*m
Nook	Nook
Anal	Anal
dope	dope
Rere	Rere
Hoes	Hoes
turd	t*rd
Fore	Fore
meth	meth
fuck	f*ck
scum	sc*m
Piky	Piky
whiz	whiz
Piss	Piss
tard	tard
bast	bast
cunt	c*nt
nazi	nazi
mams	mams
Hole	Hole
Pimp	Pimp
Nuke	N*ke
Cock	Cock
Babe	Babe
Slut	Sl*t
Fear	Fear
abbo	abbo
spig	spig
pimp	pimp
jism	jism
rere	rere
kunt	k*nt
scag	scag
slav	slav
hork	hork
orga	orga
Wank	Wank
Pube	P*be
laid	laid
Pric	Pric
Arab	Arab
Kink	Kink
peck	peck
Mofo	Mofo
Pixy	Pixy
cock	cock
Floo	Floo
dong	dong
skum	sk*m
Jizm	Jizm
groe	groe
muff	m*ff
pohm	pohm
krap	krap
Jism	Jism
shav	shav
Spig	Spig
Koon	Koon
Dead	Dead
Pi55	Pi55
Cunt	C*nt
Lies	Lies
chav	chav
Moky	Moky
boom	boom
jiga	jiga
Dike	Dike
Sexy	Sexy
Gypo	Gypo
Nazi	Nazi
Butt	B*tt
gypo	gypo
pixy	pixy
Doom	Doom
cumm	c*mm
teat	teat
blow	blow
hore	hore
heeb	heeb
jugs	j*gs
phuq	ph*q
cigs	cigs
Hore	Hore
Bong	Bong
hebe	hebe
phuk	ph*k
Arse	Arse
snot	snot
butt	b*tt
alla	alla
pric	pric
Porn	Porn
jizm	jizm
Drug	Dr*g
oral	oral
Poop	Poop
Tard	Tard
Burn	B*rn
Died	Died
piss	piss
Perv	Perv
Fire	Fire
poon	poon
doom	doom
Jade	Jade
Jigg	Jigg
Kill	Kill
Pros	Pros
Poon	Poon
Blow	Blow
damn	damn
dago	dago
kums	k*ms
vibr	vibr
Puss	P*ss
Shat	Shat
Crap	Crap
Tits	Tits
Clit	Clit
shag	shag
hell	hell
bomb	bomb
dumb	d*mb
Munt	M*nt
tits	tits
Wetb	Wetb
fear	fear
nude	n*de
jizz	jizz
anus	an*s
Meth	Meth
Gook	Gook
Dink	Dink
boob	boob
spik	spik
Geez	Geez
Lezz	Lezz
Honk	Honk
kike	kike
Dyke	Dyke
Taff	Taff
nook	nook
Phuq	Ph*q
kill	kill
Scat	Scat
Dago	Dago
slut	sl*t
milf	milf
Shav	Shav
Hebe	Hebe
whop	whop
spic	spic
wetb	wetb
Slav	Slav
porn	porn
scat	scat
Homo	Homo
drug	dr*g
Whiz	Whiz
Dive	Dive
dego	dego
barf	barf
payo	payo
lies	lies
Horn	Horn
Shag	Shag
Hapa	Hapa
Jeez	Jeez
pi55	pi55
puss	p*ss
Spit	Spit
Cigs	Cigs
whit	whit
ra8s	ra8s
Jizz	Jizz
perv	perv
died	died
Spik	Spik
Pusy	P*sy
honk	honk
Groe	Groe
rump	r*mp
shit	shit
Krap	Krap
Limy	Limy
nigr	nigr
Oral	Oral
dyke	dyke
dead	dead
Hobo	Hobo
Chav	Chav
Boom	Boom
Shit	Shit
Kock	Kock
fart	fart
Dick	Dick
poop	poop
Dumb	D*mb
geni	geni
hoes	hoes
mofo	mofo
Whit	Whit
pube	p*be
Kyke	Kyke
fuks	f*ks
dick	dick
orgy	orgy
Nigg	Nigg
burn	b*rn
Kums	K*ms
spit	spit
anal	anal
hole	hole
twat	twat
piky	piky
Suck	S*ck
Tang	Tang
Heeb	Heeb
taff	taff
arab	arab
tang	tang
Nude	N*de
babe	babe
nuke	n*ke
Vibr	Vibr
wuss	w*ss
Dies	Dies
pusy	p*sy
fore	fore
moky	moky
Dong	Dong
Smut	Sm*t
Nigr	Nigr
cunn	c*nn
Coon	Coon
gypp	gypp
kink	kink
Laid	Laid
jeez	jeez
sick	sick
koon	koon
puke	p*ke
arse	arse
Sick	Sick
Payo	Payo
Milf	Milf
hobo	hobo
Pudd	P*dd
Itch	Itch
Cumm	C*mm
Scag	Scag
Dego	Dego
Kike	Kike
suck	s*ck
horn	horn
Orgy	Orgy
pros	pros
lezz	lezz
Anus	An*s
Dope	Dope
munt	m*nt
Barf	Barf
Cunn	C*nn
Fart	Fart
Twat	Twat
Ikey	Ikey
Whop	Whop
Jugs	J*gs
Turd	T*rd
Jiga	Jiga
Peck	Peck
hapa	hapa
Phuk	Ph*k
Gipp	Gipp
Puke	P*ke
Ra8s	Ra8s
paki	paki
dies	dies
limy	limy
deth	deth
Muff	M*ff
Quim	Q*im
Hook	Hook
Bomb	Bomb
Wuss	W*ss
Scum	Sc*m
Chin	Chin
Spic	Spic
Boob	Boob
fire	fire
hook	hook
dike	dike
kock	kock
nigg	nigg
coon	coon
sexy	sexy
Rump	R*mp
Fuck	F*ck
clit	clit
Fuks	F*ks
dink	dink
shat	shat
kyke	kyke
smut	sm*t
floo	floo
Deth	Deth
chin	chin
Orga	Orga
Abbo	Abbo
pudd	p*dd
itch	itch
Rape	Rape
jade	jade
gook	gook
Bomd	Bomd
Damn	Damn
Alla	Alla
Snot	Snot
wank	wank
Bast	Bast
rape	rape
homo	homo
crap	crap
quim	q*im
Pohm	Pohm
Kunt	K*nt
bong	bong
dive	dive
Teat	Teat
Hork	Hork
Geni	Geni
Mams	Mams
geez	geez
gipp	gipp
Gypp	Gypp
jew	jew
Uck	Uck
jiz	jiz
gob	gob
Pud	P*d
sob	sob
God	God
sex	sex
Ass	Ass
pot	pot
Xxx	Xxx
Poo	Poo
dix	dix
nip	nip
Wog	Wog
kkk	kkk
nig	nig
Goy	Goy
gin	gin
poo	poo
Sob	Sob
Fuc	F*c
Xtc	Xtc
wop	wop
Gay	Gay
pee	pee
Dix	Dix
Jew	Jew
wab	wab
Mad	Mad
pud	p*d
ero	ero
Sex	Sex
fat	fat
hiv	hiv
Evl	Evl
jap	jap
tnt	tnt
Tit	Tit
gun	g*n
wtf	wtf
Pom	Pom
Lez	Lez
Gob	Gob
goy	goy
Fuk	F*k
uck	*ck
Fat	Fat
bra	bra
Tnt	Tnt
cum	c*m
wog	wog
ass	ass
Kkk	Kkk
Pee	Pee
Jap	Jap
Abo	Abo
Cum	C*m
Nip	Nip
sos	sos
pom	pom
xtc	xtc
tit	tit
Gyp	Gyp
fuk	f*k
evl	evl
xxx	xxx
Gun	G*n
Kid	Kid
fok	fok
mad	mad
Sos	Sos
Fok	Fok
Gin	Gin
kum	k*m
Fag	Fag
Wab	Wab
abo	abo
die	die
kid	kid
gyp	gyp
Hiv	Hiv
lsd	lsd
gay	gay
god	god
Nig	Nig
Bra	Bra
Jiz	Jiz
Pot	Pot
Wop	Wop
Kum	K*m
Lsd	Lsd
lez	lez
fag	fag
Wtf	Wtf
fuc	f*c
Ero	Ero
Die	Die
uk	*k
wn	wn
ho	ho
ky	ky
Wn	Wn
Uk	Uk
fu	f*
Ky	Ky
bi	bi
Bi	Bi
Ho	Ho
Fu	F*
