original	new
Gaymuthafuckinwhore	Gaymuthafuck!nwhore
gaymuthafuckinwhore	gaymuthafuck!nwhore
Goddamnmuthafucker	Goddamnmuthafucker
goddamnmuthafucker	goddamnmuthafucker
mattressprincess	mattresspr!ncess
Mattressprincess	Mattresspr!ncess
spaghettibender	spaghett!bender
spaghettinigger	spaghett!n!gger
Spaghettibender	Spaghett!bender
devilworshipper	dev!lworsh!pper
niggardliness's	n!ggardl!ness's
Spaghettinigger	Spaghett!n!gger
Devilworshipper	Dev!lworsh!pper
Niggardliness's	N!ggardl!ness's
Motherfuckings	Motherfuck!ngs
Poorwhitetrash	Poorwh!tetrash
spankthemonkey	spankthemonkey
smackthemonkey	smackthemonkey
purinapricness	pur!napr!cness
Motherlovebone	Motherlovebone
Luckycammeltoe	Luckycammeltoe
Purinapricness	Pur!napr!cness
motherfuckings	motherfuck!ngs
motherlovebone	motherlovebone
Spankthemonkey	Spankthemonkey
poorwhitetrash	poorwh!tetrash
Smackthemonkey	Smackthemonkey
luckycammeltoe	luckycammeltoe
Alligatorbait	All!gatorba!t
jacktheripper	jackther!pper
Tongethruster	Tongethruster
Carpetmuncher	Carpetmuncher
shitforbrains	sh!tforbra!ns
fingerfucking	f!ngerfuck!ng
Motherfucking	Motherfuck!ng
pooperscooper	pooperscooper
Masterblaster	Masterblaster
dickforbrains	d!ckforbra!ns
Jacktheripper	Jackther!pper
Fingerfuckers	F!ngerfuckers
fingerfuckers	f!ngerfuckers
Pooperscooper	Pooperscooper
Fingerfucking	F!ngerfuck!ng
niggardliness	n!ggardl!ness
carpetmuncher	carpetmuncher
virginbreaker	v!rg!nbreaker
Shitforbrains	Sh!tforbra!ns
pearlnecklace	pearlnecklace
Virginbreaker	V!rg!nbreaker
Assassination	Assass!nat!on
shitoutofluck	sh!toutofluck
Niggardliness	N!ggardl!ness
assassination	assass!nat!on
tongethruster	tongethruster
Mothafuckings	Mothafuck!ngs
mothafuckings	mothafuck!ngs
Shitoutofluck	Sh!toutofluck
masterblaster	masterblaster
alligatorbait	all!gatorba!t
Dickforbrains	D!ckforbra!ns
motherfucking	motherfuck!ng
Pearlnecklace	Pearlnecklace
Pussypounder	Pussypounder
Heterosexual	Heterosexual
transvestite	transvest!te
freakyfucker	freakyfucker
Conservative	Conservat!ve
masturbating	masturbat!ng
Fingerfucked	F!ngerfucked
motherfucker	motherfucker
Transvestite	Transvest!te
Pornprincess	Pornpr!ncess
pussypounder	pussypounder
pornprincess	pornpr!ncess
Cherrypopper	Cherrypopper
motherfucked	motherfucked
Mothafucking	Mothafuck!ng
grostulation	grostulat!on
Goldenshower	Goldenshower
fingerfucker	f!ngerfucker
Fuckingbitch	Fuck!ngb!tch
Titbitnipply	T!tb!tn!pply
crotchmonkey	crotchmonkey
tunneloflove	tunneloflove
Timbernigger	T!mbern!gger
Spermhearder	Spermhearder
Motherfuckin	Motherfuck!n
crotchjockey	crotchjockey
Trailertrash	Tra!lertrash
Motherfucker	Motherfucker
Motherfucked	Motherfucked
williewanker	w!ll!ewanker
Fingerfucker	F!ngerfucker
fingerfucked	f!ngerfucked
trailertrash	tra!lertrash
Tunneloflove	Tunneloflove
tonguethrust	tonguethrust
motherfuckin	motherfuck!n
Masturbating	Masturbat!ng
Crotchmonkey	Crotchmonkey
butt-fuckers	butt-fuckers
mothafucking	mothafuck!ng
goldenshower	goldenshower
stupidfucker	stup!dfucker
Freakyfucker	Freakyfucker
Stupidfucker	Stup!dfucker
Lezbefriends	Lezbefr!ends
athletesfoot	athletesfoot
Williewanker	W!ll!ewanker
timbernigger	t!mbern!gger
spermhearder	spermhearder
fuckingbitch	fuck!ngb!tch
Athletesfoot	Athletesfoot
nofuckingway	nofuck!ngway
cherrypopper	cherrypopper
Crotchjockey	Crotchjockey
beatyourmeat	beatyourmeat
titbitnipply	t!tb!tn!pply
heterosexual	heterosexual
Butt-fuckers	Butt-fuckers
lezbefriends	lezbefr!ends
Beatyourmeat	Beatyourmeat
Nofuckingway	Nofuck!ngway
Tonguethrust	Tonguethrust
Grostulation	Grostulat!on
conservative	conservat!ve
crack-whore	crack-whore
sonofabitch	sonofab!tch
Mothafuckaz	Mothafuckaz
Shithappens	Sh!thappens
doggiestyle	dogg!estyle
Junglebunny	Junglebunny
cuntlicking	cuntl!ck!ng
Intercourse	Intercourse
Twobitwhore	Twob!twhore
Fudgepacker	Fudgepacker
tonguetramp	tonguetramp
pussyfucker	pussyfucker
homobangers	homobangers
mothafuckin	mothafuck!n
Butt-fucker	Butt-fucker
Doggiestyle	Dogg!estyle
mooncricket	mooncr!cket
Ejaculating	Ejaculat!ng
Fistfucking	F!stfuck!ng
Backdoorman	Backdoorman
Penetration	Penetrat!on
Pussyfucker	Pussyfucker
executioner	execut!oner
Crack-whore	Crack-whore
whiskeydick	wh!skeyd!ck
Whorefucker	Whorefucker
junglebunny	junglebunny
Fuckinright	Fuck!nr!ght
spreadeagle	spreadeagle
Cunillingus	Cun!ll!ngus
Holestuffer	Holestuffer
Buttfuckers	Buttfuckers
ejaculation	ejaculat!on
Cuntlicking	Cuntl!ck!ng
intercourse	!ntercourse
Fannyfucker	Fannyfucker
Pussylicker	Pussyl!cker
porchmonkey	porchmonkey
Beastiality	Beast!al!ty
snatchpatch	snatchpatch
kunnilingus	kunn!l!ngus
Mothafuckin	Mothafuck!n
beastiality	beast!al!ty
molestation	molestat!on
Whitenigger	Wh!ten!gger
Molestation	Molestat!on
cyberslimer	cybersl!mer
mothafucker	mothafucker
Buttmuncher	Buttmuncher
interracial	!nterrac!al
fistfucking	f!stfuck!ng
fudgepacker	fudgepacker
ejaculating	ejaculat!ng
whorefucker	whorefucker
Kunnilingus	Kunn!l!ngus
Spermherder	Spermherder
Cunnilingus	Cunn!l!ngus
Tonguetramp	Tonguetramp
slimebucket	sl!mebucket
cockblocker	cockblocker
Slimebucket	Sl!mebucket
Snatchpatch	Snatchpatch
Whiskeydick	Wh!skeyd!ck
buttmuncher	buttmuncher
Cameljockey	Cameljockey
Dingleberry	D!ngleberry
Mastrabator	Mastrabator
Glazeddonut	Glazeddonut
transsexual	transsexual
Cockblocker	Cockblocker
shithappens	sh!thappens
cunnilingus	cunn!l!ngus
pussylicker	pussyl!cker
palestinian	palest!n!an
slavedriver	slavedr!ver
Meatbeatter	Meatbeatter
Executioner	Execut!oner
twobitwhore	twob!twhore
Pornography	Pornography
butt-fucker	butt-fucker
cocksucking	cocksuck!ng
Cocksucking	Cocksuck!ng
Breastlover	Breastlover
Ejaculation	Ejaculat!on
pornography	pornography
cameljockey	cameljockey
whitenigger	wh!ten!gger
Jesuschrist	Jesuschr!st
Interracial	Interrac!al
spermherder	spermherder
jesuschrist	jesuschr!st
cunillingus	cun!ll!ngus
Mothafucker	Mothafucker
dingleberry	d!ngleberry
mothafuckaz	mothafuckaz
Sonofabitch	Sonofab!tch
Cyberslimer	Cybersl!mer
Palestinian	Palest!n!an
skankybitch	skankyb!tch
barelylegal	barelylegal
mastrabator	mastrabator
Skankywhore	Skankywhore
meatbeatter	meatbeatter
Slavedriver	Slavedr!ver
fuckinright	fuck!nr!ght
muffindiver	muff!nd!ver
Skankybitch	Skankyb!tch
Transsexual	Transsexual
penetration	penetrat!on
buttfuckers	buttfuckers
backdoorman	backdoorman
mothafucked	mothafucked
breastlover	breastlover
fannyfucker	fannyfucker
Hillbillies	H!llb!ll!es
assassinate	assass!nate
Mothafucked	Mothafucked
Muffindiver	Muff!nd!ver
hillbillies	h!llb!ll!es
holestuffer	holestuffer
Barelylegal	Barelylegal
Homobangers	Homobangers
Porchmonkey	Porchmonkey
glazeddonut	glazeddonut
skankywhore	skankywhore
Assassinate	Assass!nate
Mooncricket	Mooncr!cket
Spreadeagle	Spreadeagle
fingerfood	f!ngerfood
fuckmehard	fuckmehard
Deepthroat	Deepthroat
Mothafucka	Mothafucka
Transexual	Transexual
Footaction	Footact!on
Lovemuscle	Lovemuscle
fingerfuck	f!ngerfuck
fistfucked	f!stfucked
deapthroat	deapthroat
bumblefuck	bumblefuck
Motherfuck	Motherfuck
Fuckmehard	Fuckmehard
nastybitch	nastyb!tch
footfucker	footfucker
Loverocket	Loverocket
assblaster	assblaster
Snownigger	Snown!gger
fuckinnuts	fuck!nnuts
pickaninny	p!ckan!nny
deepthroat	deepthroat
protestant	protestant
Butchbabes	Butchbabes
bestiality	best!al!ty
assmuncher	assmuncher
cuntfucker	cuntfucker
sandnigger	sandn!gger
masturbate	masturbate
doggystyle	doggystyle
Niggarding	N!ggard!ng
Doggystyle	Doggystyle
masterbate	masterbate
Sandnigger	Sandn!gger
Masterbate	Masterbate
Mufflikcer	Muffl!kcer
Cocksmoker	Cocksmoker
mufflikcer	muffl!kcer
footlicker	footl!cker
Fourtwenty	Fourtwenty
Pocketpool	Pocketpool
flatulence	flatulence
sixtyniner	s!xtyn!ner
Shawtypimp	Shawtyp!mp
shawtypimp	shawtyp!mp
asspuppies	asspupp!es
samckdaddy	samckdaddy
children's	ch!ldren's
sniggering	sn!gger!ng
Flatulence	Flatulence
Lovepistol	Lovep!stol
Palesimian	Pales!m!an
pussyeater	pussyeater
Headlights	Headl!ghts
Bigbastard	B!gbastard
sleezeball	sleezeball
Fingerfuck	F!ngerfuck
greaseball	greaseball
lovemuscle	lovemuscle
suckmydick	suckmyd!ck
Mickeyfinn	M!ckeyf!nn
republican	republ!can
dicklicker	d!ckl!cker
Sonofbitch	Sonofb!tch
Balllicker	Balll!cker
Propaganda	Propaganda
Beastality	Beastal!ty
whiskydick	wh!skyd!ck
cocksmoker	cocksmoker
gangbanged	gangbanged
Gangbanged	Gangbanged
fourtwenty	fourtwenty
Bestiality	Best!al!ty
transexual	transexual
propaganda	propaganda
facefucker	facefucker
Fistfucker	F!stfucker
Dicklicker	D!ckl!cker
kunilingus	kun!l!ngus
Cuntfucker	Cuntfucker
Cocklicker	Cockl!cker
pussylover	pussylover
Shitfucker	Sh!tfucker
cocklicker	cockl!cker
Suckmydick	Suckmyd!ck
peckerwood	peckerwood
Niggaracci	N!ggaracc!
Gangbanger	Gangbanger
mothafucka	mothafucka
Pussylover	Pussylover
beastality	beastal!ty
footaction	footact!on
Homosexual	Homosexual
Peckerwood	Peckerwood
snownigger	snown!gger
nipplering	n!ppler!ng
Nastybitch	Nastyb!tch
Australian	Austral!an
gonorrehea	gonorrehea
pocketpool	pocketpool
Sixtyniner	S!xtyn!ner
cocksucker	cocksucker
Whitetrash	Wh!tetrash
Footfucker	Footfucker
Facefucker	Facefucker
Sleezeball	Sleezeball
Cuntsucker	Cuntsucker
loverocket	loverocket
crackwhore	crackwhore
Stupidfuck	Stup!dfuck
Cuntlicker	Cuntl!cker
stupidfuck	stup!dfuck
Gonorrehea	Gonorrehea
Spermacide	Spermac!de
cunilingus	cun!l!ngus
Unfuckable	Unfuckable
prostitute	prost!tute
gangbanger	gangbanger
niggaracci	n!ggaracc!
Fistfucked	F!stfucked
nastywhore	nastywhore
Children's	Ch!ldren's
skankbitch	skankb!tch
conspiracy	consp!racy
corruption	corrupt!on
Deapthroat	Deapthroat
sonofbitch	sonofb!tch
Fuckinnuts	Fuck!nnuts
Skankbitch	Skankb!tch
motherfuck	motherfuck
cuntlicker	cuntl!cker
buttfucker	buttfucker
Crackwhore	Crackwhore
clamdigger	clamd!gger
shithapens	sh!thapens
Greaseball	Greaseball
australian	austral!an
zipperhead	z!pperhead
cockcowboy	cockcowboy
piccaninny	p!ccan!nny
balllicker	balll!cker
mickeyfinn	m!ckeyf!nn
Assblaster	Assblaster
bigbastard	b!gbastard
homosexual	homosexual
Niggerhole	N!ggerhole
Corruption	Corrupt!on
cuntsucker	cuntsucker
Chickslick	Ch!cksl!ck
Fuckmonkey	Fuckmonkey
fuckfriend	fuckfr!end
Pussyeater	Pussyeater
Protestant	Protestant
Prostitute	Prost!tute
Whorehouse	Whorehouse
Cocksucked	Cocksucked
whitetrash	wh!tetrash
mastabater	mastabater
Cunilingus	Cun!l!ngus
niggerhole	n!ggerhole
cocksucked	cocksucked
Masturbate	Masturbate
niggerhead	n!ggerhead
headlights	headl!ghts
Buttpirate	Buttp!rate
Republican	Republ!can
Kunilingus	Kun!l!ngus
lovepistol	lovep!stol
Nipplering	N!ppler!ng
Conspiracy	Consp!racy
Piccaninny	P!ccan!nny
spermacide	spermac!de
Niggerhead	N!ggerhead
Zipperhead	Z!pperhead
Shithapens	Sh!thapens
Sniggering	Sn!gger!ng
Fuckfriend	Fuckfr!end
Skankwhore	Skankwhore
Clamdigger	Clamd!gger
Buttfucker	Buttfucker
Mastabater	Mastabater
buttpirate	buttp!rate
fuckmonkey	fuckmonkey
chickslick	ch!cksl!ck
niggarding	n!ggard!ng
fistfucker	f!stfucker
unfuckable	unfuckable
Cocksucker	Cocksucker
Assmuncher	Assmuncher
Bumblefuck	Bumblefuck
Fingerfood	F!ngerfood
Cockcowboy	Cockcowboy
shitfucker	sh!tfucker
ejaculated	ejaculated
Ejaculated	Ejaculated
butchbabes	butchbabes
skankwhore	skankwhore
Nastywhore	Nastywhore
Asspuppies	Asspupp!es
Pickaninny	P!ckan!nny
Samckdaddy	Samckdaddy
whorehouse	whorehouse
Footlicker	Footl!cker
Whiskydick	Wh!skyd!ck
palesimian	pales!m!an
shortfuck	shortfuck
cocksmith	cocksm!th
Assfucker	Assfucker
marijuana	mar!juana
butchdike	butchd!ke
Asslicker	Assl!cker
pornflick	pornfl!ck
cockblock	cockblock
Titfucker	T!tfucker
cumbubble	cumbubble
Slaughter	Slaughter
picaninny	p!can!nny
Sniggered	Sn!ggered
Rearentry	Rearentry
Breastjob	Breastjob
fuckfreak	fuckfreak
fatfucker	fatfucker
titfuckin	t!tfuck!n
disturbed	d!sturbed
Asscowboy	Asscowboy
cumjockey	cumjockey
ethiopian	eth!op!an
Marijuana	Mar!juana
Nigerians	N!ger!ans
assbagger	assbagger
fornicate	forn!cate
upthebutt	upthebutt
magicwand	mag!cwand
Feltching	Feltch!ng
Shitfaced	Sh!tfaced
Loadedgun	Loadedgun
Penthouse	Penthouse
Sexy-slim	Sexy-sl!m
Analannie	Analann!e
slideitin	sl!de!t!n
snigger's	sn!gger's
Suckmytit	Suckmyt!t
Buttmunch	Buttmunch
Trisexual	Tr!sexual
explosion	explos!on
Assranger	Assranger
sweetness	sweetness
Cocklover	Cocklover
Goddamnit	Goddamn!t
Stripclub	Str!pclub
Magicwand	Mag!cwand
pimpjuice	p!mpju!ce
Crackpipe	Crackp!pe
buttstain	buttsta!n
Titlicker	T!tl!cker
Horseshit	Horsesh!t
bountybar	bountybar
pussylips	pussyl!ps
swallower	swallower
lovejuice	loveju!ce
Suckmyass	Suckmyass
Shithouse	Sh!thouse
Freakfuck	Freakfuck
Primetime	Pr!met!me
sniggered	sn!ggered
Ethiopian	Eth!op!an
asscowboy	asscowboy
Buttstain	Buttsta!n
execution	execut!on
rearentry	rearentry
Asskisser	Assk!sser
Ejaculate	Ejaculate
Dixiedyke	D!x!edyke
stripclub	str!pclub
ejaculate	ejaculate
goddammit	goddamm!t
Slutwhore	Slutwhore
hitlerist	h!tler!st
Catholics	Cathol!cs
Moneyshot	Moneyshot
asskisser	assk!sser
skinflute	sk!nflute
testicles	test!cles
slimeball	sl!meball
Bootycall	Bootycall
dumbbitch	dumbb!tch
nigerians	n!ger!ans
fuckbuddy	fuckbuddy
Cumjockey	Cumjockey
Sweetness	Sweetness
cockqueen	cockqueen
Cocktease	Cocktease
skankfuck	skankfuck
pubiclice	pub!cl!ce
Mastabate	Mastabate
asslicker	assl!cker
prickhead	pr!ckhead
Cockrider	Cockr!der
mastabate	mastabate
Cigarette	C!garette
clamdiver	clamd!ver
Kumbullbe	Kumbullbe
gatorbait	gatorba!t
Nastyslut	Nastyslut
Threesome	Threesome
niggardly	n!ggardly
Swallower	Swallower
niggarded	n!ggarded
criminals	cr!m!nals
penthouse	penthouse
cocklover	cocklover
Sleezebag	Sleezebag
yellowman	yellowman
Clamdiver	Clamd!ver
dixiedike	d!x!ed!ke
slaughter	slaughter
niggard's	n!ggard's
towelhead	towelhead
Fuckbuddy	Fuckbuddy
primetime	pr!met!me
feltching	feltch!ng
goddamned	goddamned
bitchslap	b!tchslap
nigglings	n!ggl!ngs
slutwhore	slutwhore
Fornicate	Forn!cate
sexkitten	sexk!tten
Premature	Premature
titlicker	t!tl!cker
Dumbbitch	Dumbb!tch
bi-sexual	b!-sexual
assmonkey	assmonkey
Communist	Commun!st
butt-fuck	butt-fuck
Christian	Chr!st!an
Muffdiver	Muffd!ver
Mothafuck	Mothafuck
Fuckfreak	Fuckfreak
goddamnit	goddamn!t
sixsixsix	s!xs!xs!x
goddamnes	goddamnes
dickbrain	d!ckbra!n
Testicles	Test!cles
Butt-bang	Butt-bang
kumbullbe	kumbullbe
shitfaced	sh!tfaced
Hitlerism	H!tler!sm
Disturbed	D!sturbed
damnation	damnat!on
Execution	Execut!on
butchdyke	butchdyke
Niggardly	N!ggardly
Terrorist	Terror!st
suckmytit	suckmyt!t
Fatfucker	Fatfucker
Dragqueen	Dragqueen
asspacker	asspacker
Butchdyke	Butchdyke
Dixiedike	D!x!ed!ke
Dragqween	Dragqween
Towelhead	Towelhead
butt-bang	butt-bang
Assmonkey	Assmonkey
Bicurious	B!cur!ous
assfucker	assfucker
Splittail	Spl!tta!l
shitstain	sh!tsta!n
slopehead	slopehead
Explosion	Explos!on
Asspacker	Asspacker
buttmunch	buttmunch
cocktease	cocktease
Kumbubble	Kumbubble
threesome	threesome
freakfuck	freakfuck
Upthebutt	Upthebutt
sexy-slim	sexy-sl!m
Crotchrot	Crotchrot
Nigglings	N!ggl!ngs
Sixtynine	S!xtyn!ne
asspirate	assp!rate
cockrider	cockr!der
Pornflick	Pornfl!ck
Criminals	Cr!m!nals
premature	premature
dragqween	dragqween
Skinflute	Sk!nflute
Yellowman	Yellowman
Fuckwhore	Fuckwhore
splittail	spl!tta!l
Cockfight	Cockf!ght
Skankfuck	Skankfuck
rentafuck	rentafuck
fuckwhore	fuckwhore
Sexkitten	Sexk!tten
Pimpjuice	P!mpju!ce
nutfucker	nutfucker
crotchrot	crotchrot
Butchdike	Butchd!ke
Cockqueen	Cockqueen
hottotrot	hottotrot
Hijacking	H!jack!ng
Rentafuck	Rentafuck
Titfuckin	T!tfuck!n
analannie	analann!e
loadedgun	loadedgun
cigarette	c!garette
Hitlerist	H!tler!st
scallywag	scallywag
moneyshot	moneyshot
shiteater	sh!teater
Bi-sexual	B!-sexual
dragqueen	dragqueen
Cocksucer	Cocksucer
Shitstain	Sh!tsta!n
Hottotrot	Hottotrot
excrement	excrement
christian	chr!st!an
breastjob	breastjob
cockfight	cockf!ght
Pubiclice	Pub!cl!ce
communist	commun!st
Cockblock	Cockblock
suckmyass	suckmyass
hijacking	h!jack!ng
mothafuck	mothafuck
titfucker	t!tfucker
Pussylips	Pussyl!ps
Assbagger	Assbagger
Damnation	Damnat!on
sleezebag	sleezebag
bicurious	b!cur!ous
Bountybar	Bountybar
Excrement	Excrement
horseshit	horsesh!t
Butt-fuck	Butt-fuck
Goddammit	Goddamm!t
assranger	assranger
catholics	cathol!cs
shithouse	sh!thouse
kumbubble	kumbubble
Cocksmith	Cocksm!th
Picaninny	P!can!nny
Prickhead	Pr!ckhead
Cumbubble	Cumbubble
Shortfuck	Shortfuck
Nutfucker	Nutfucker
Goddamned	Goddamned
Bitchslap	B!tchslap
Goddamnes	Goddamnes
hitlerism	h!tler!sm
cocksucer	cocksucer
thicklips	th!ckl!ps
assjockey	assjockey
sixtynine	s!xtyn!ne
Inthebuff	Inthebuff
breastman	breastman
Lovejuice	Loveju!ce
Scallywag	Scallywag
Asspirate	Assp!rate
Niggard's	N!ggard's
Slimeball	Sl!meball
trisexual	tr!sexual
inthebuff	!nthebuff
bootycall	bootycall
dixiedyke	d!x!edyke
Gatorbait	Gatorba!t
Dickbrain	D!ckbra!n
Thicklips	Th!ckl!ps
Sixsixsix	S!xs!xs!x
Shiteater	Sh!teater
muffdiver	muffd!ver
Slideitin	Sl!de!t!n
nastyslut	nastyslut
Assjockey	Assjockey
Snigger's	Sn!gger's
Breastman	Breastman
Slopehead	Slopehead
crackpipe	crackp!pe
Niggarded	N!ggarded
terrorist	terror!st
narcotic	narcot!c
Homicide	Hom!c!de
Roundeye	Roundeye
Headfuck	Headfuck
Threeway	Threeway
hijacker	h!jacker
Sniggers	Sn!ggers
cockknob	cockknob
homicide	hom!c!de
lapdance	lapdance
cocktail	cockta!l
diseases	d!seases
Buttplug	Buttplug
Felching	Felch!ng
niggards	n!ggards
Phonesex	Phonesex
bullshit	bullsh!t
testicle	test!cle
murderer	murderer
ballsack	ballsack
freefuck	freefuck
Footfuck	Footfuck
cunteyed	cunteyed
Foursome	Foursome
screwyou	screwyou
Abortion	Abort!on
jackshit	jacksh!t
muffdive	muffd!ve
buttface	buttface
Fuckface	Fuckface
vibrator	v!brator
Copulate	Copulate
niggling	n!ggl!ng
sexhound	sexhound
Bullcrap	Bullcrap
jizjuice	j!zju!ce
snowback	snowback
lovebone	lovebone
Filipino	F!l!p!no
backseat	backseat
bisexual	b!sexual
coloured	coloured
Eatpussy	Eatpussy
Butthead	Butthead
fuckedup	fuckedup
Horniest	Horn!est
sniggers	sn!ggers
Retarded	Retarded
Shagging	Shagg!ng
executed	executed
sodomize	sodom!ze
cemetery	cemetery
Criminal	Cr!m!nal
Redlight	Redl!ght
playgirl	playg!rl
Datnigga	Datn!gga
Testicle	Test!cle
Givehead	G!vehead
barfface	barfface
Nigerian	N!ger!an
filipina	f!l!p!na
sexhouse	sexhouse
Defecate	Defecate
Cockhead	Cockhead
datnigga	datn!gga
Vietcong	V!etcong
shitface	sh!tface
roundeye	roundeye
bunghole	bunghole
chinamen	ch!namen
chinaman	ch!naman
Sodomise	Sodom!se
bullcrap	bullcrap
fuckfest	fuckfest
Peepshow	Peepshow
manhater	manhater
clitoris	cl!tor!s
Erection	Erect!on
Filipina	F!l!p!na
Lapdance	Lapdance
Jackshit	Jacksh!t
Ballsack	Ballsack
thirdeye	th!rdeye
Buttfuck	Buttfuck
sexually	sexually
Narcotic	Narcot!c
Thirdeye	Th!rdeye
dripdick	dr!pd!ck
dickless	d!ckless
Assholes	Assholes
Barfface	Barfface
Cocksuck	Cocksuck
assmunch	assmunch
Pussycat	Pussycat
Uptheass	Uptheass
Thirdleg	Th!rdleg
Knockers	Knockers
Fuckable	Fuckable
Slutwear	Slutwear
Mosshead	Mosshead
spermbag	spermbag
Shitlist	Sh!tl!st
footfuck	footfuck
fuckface	fuckface
retarded	retarded
Lovebone	Lovebone
foreskin	foresk!n
Cunteyed	Cunteyed
minority	m!nor!ty
blackout	blackout
Nigger's	N!gger's
Screwyou	Screwyou
Sexhouse	Sexhouse
Bullshit	Bullsh!t
foursome	foursome
stroking	strok!ng
Tuckahoe	Tuckahoe
sexwhore	sexwhore
Spigotty	Sp!gotty
buttbang	buttbang
footstar	footstar
syphilis	syph!l!s
swastika	swast!ka
Assassin	Assass!n
canadian	canad!an
gotohell	gotohell
abortion	abort!on
Dickless	D!ckless
assklown	assklown
Cumqueen	Cumqueen
pimpjuic	p!mpju!c
Arsehole	Arsehole
Sexhound	Sexhound
goddamit	goddam!t
Bulldike	Bulld!ke
cocksman	cocksman
Fuckhead	Fuckhead
Assclown	Assclown
defecate	defecate
Cockknob	Cockknob
Stringer	Str!nger
Dicklick	D!ckl!ck
dicklick	d!ckl!ck
Coloured	Coloured
easyslut	easyslut
Canadian	Canad!an
pornking	pornk!ng
buggered	buggered
gonzagas	gonzagas
felching	felch!ng
Suckdick	Suckd!ck
Shitfull	Sh!tfull
Bisexual	B!sexual
blackman	blackman
fellatio	fellat!o
Jizjuice	J!zju!ce
Dumbfuck	Dumbfuck
Cemetery	Cemetery
godammit	godamm!t
mosshead	mosshead
Cocktail	Cockta!l
fuckknob	fuckknob
Spermbag	Spermbag
Fucktard	Fucktard
molestor	molestor
shitdick	sh!td!ck
Dickweed	D!ckweed
Manpaste	Manpaste
Sodomite	Sodom!te
beastial	beast!al
Executed	Executed
Vibrator	V!brator
vibrater	v!brater
cockhead	cockhead
knockers	knockers
nigerian	n!ger!an
Muffdive	Muffd!ve
molester	molester
Asswhore	Asswhore
hotpussy	hotpussy
Radicals	Rad!cals
Italiano	Ital!ano
Fuckfest	Fuckfest
shitlist	sh!tl!st
vietcong	v!etcong
phukking	phukk!ng
Fuckedup	Fuckedup
european	european
Sodomize	Sodom!ze
Buggered	Buggered
Chinaman	Ch!naman
nigger's	n!gger's
Gotohell	Gotohell
Diseases	D!seases
Easyslut	Easyslut
Slanteye	Slanteye
slanteye	slanteye
shagging	shagg!ng
lingerie	l!nger!e
Jijjiboo	J!jj!boo
Sexwhore	Sexwhore
violence	v!olence
Shitting	Sh!tt!ng
bulldike	bulld!ke
Minority	M!nor!ty
Blackout	Blackout
shitfuck	sh!tfuck
pimpsimp	p!mps!mp
Lingerie	L!nger!e
Assmunch	Assmunch
Dipstick	D!pst!ck
Dickhead	D!ckhead
Feltcher	Feltcher
Bulldyke	Bulldyke
threeway	threeway
Sexymoma	Sexymoma
Godammit	Godamm!t
Fuckknob	Fuckknob
erection	erect!on
pussycat	pussycat
Swastika	Swast!ka
slutwear	slutwear
Titlover	T!tlover
cuntlick	cuntl!ck
shitfull	sh!tfull
Foreskin	Foresk!n
cybersex	cybersex
Clitoris	Cl!tor!s
Limpdick	L!mpd!ck
Phukking	Phukk!ng
cornhole	cornhole
Gangbang	Gangbang
meatrack	meatrack
Japanese	Japanese
Fistfuck	F!stfuck
Buttbang	Buttbang
buttfuck	buttfuck
Violence	V!olence
Murderer	Murderer
Bunghole	Bunghole
fucktard	fucktard
European	European
cuntfuck	cuntfuck
Shooting	Shoot!ng
beat-off	beat-off
givehead	g!vehead
japanese	japanese
Asslover	Asslover
Shithead	Sh!thead
Cornhole	Cornhole
Assklown	Assklown
ontherag	ontherag
showtime	showt!me
tuckahoe	tuckahoe
israel's	!srael's
spigotty	sp!gotty
suckdick	suckd!ck
fuckhead	fuckhead
Sexually	Sexually
criminal	cr!m!nal
headfuck	headfuck
Shitface	Sh!tface
Shitdick	Sh!td!ck
Ontherag	Ontherag
Niggards	N!ggards
Beat-off	Beat-off
intheass	!ntheass
sodomite	sodom!te
sodomise	sodom!se
sexymoma	sexymoma
Footstar	Footstar
Intheass	Intheass
Beastial	Beast!al
butthead	butthead
Pimpsimp	P!mps!mp
phonesex	phonesex
Hijacker	H!jacker
Fastfuck	Fastfuck
Showtime	Showt!me
asslover	asslover
Pimpjuic	P!mpju!c
Goddamit	Goddam!t
Pisshead	P!sshead
shithead	sh!thead
jijjiboo	j!jj!boo
Pornking	Pornk!ng
Chinamen	Ch!namen
dumbfuck	dumbfuck
uptheass	uptheass
gangbang	gangbang
Manhater	Manhater
filipino	f!l!p!no
Henhouse	Henhouse
Gonzagas	Gonzagas
american	amer!can
titlover	t!tlover
Bitching	B!tch!ng
Molester	Molester
eatballs	eatballs
eatpussy	eatpussy
dipstick	d!pst!ck
Playgirl	Playg!rl
Sexslave	Sexslave
shooting	shoot!ng
Vibrater	V!brater
Dripdick	Dr!pd!ck
radicals	rad!cals
Cuntfuck	Cuntfuck
asswhore	asswhore
poontang	poontang
cumqueen	cumqueen
Snowback	Snowback
assclown	assclown
Slutting	Slutt!ng
pisshead	p!sshead
Cocksman	Cocksman
Fellatio	Fellat!o
bazongas	bazongas
Cameltoe	Cameltoe
Hotpussy	Hotpussy
American	Amer!can
assassin	assass!n
Bazongas	Bazongas
cocksuck	cocksuck
henhouse	henhouse
sexslave	sexslave
backdoor	backdoor
Backseat	Backseat
bulldyke	bulldyke
Catholic	Cathol!c
Shitfuck	Sh!tfuck
Blackman	Blackman
Backdoor	Backdoor
assholes	assholes
thirdleg	th!rdleg
Syphilis	Syph!l!s
Poontang	Poontang
buttplug	buttplug
manpaste	manpaste
cameltoe	cameltoe
Niggling	N!ggl!ng
slutting	slutt!ng
arsehole	arsehole
bitching	b!tch!ng
stringer	str!nger
dickweed	d!ckweed
peepshow	peepshow
redlight	redl!ght
limpdick	l!mpd!ck
Buttface	Buttface
Peepshpw	Peepshpw
fuckable	fuckable
Cuntlick	Cuntl!ck
fastfuck	fastfuck
feltcher	feltcher
Molestor	Molestor
copulate	copulate
Eatballs	Eatballs
fistfuck	f!stfuck
Stroking	Strok!ng
Freefuck	Freefuck
Israel's	Israel's
peepshpw	peepshpw
italiano	!tal!ano
Meatrack	Meatrack
Cybersex	Cybersex
horniest	horn!est
shitting	sh!tt!ng
catholic	cathol!c
dickhead	d!ckhead
poverty	poverty
cumshot	cumshot
colored	colored
bitchez	b!tchez
Lesbain	Lesba!n
Reestie	Reest!e
lesbian	lesb!an
drunken	drunken
pooping	poop!ng
Bombing	Bomb!ng
hotdamn	hotdamn
negro's	negro's
Lucifer	Luc!fer
Bastard	Bastard
Lovegoo	Lovegoo
Suicide	Su!c!de
dumbass	dumbass
fagging	fagg!ng
jiggabo	j!ggabo
sexfarm	sexfarm
Mulatto	Mulatto
niggard	n!ggard
Peehole	Peehole
Genital	Gen!tal
Shitter	Sh!tter
Bitcher	B!tcher
Funfuck	Funfuck
lucifer	luc!fer
japcrap	japcrap
Pissing	P!ss!ng
liberal	l!beral
Urinary	Ur!nary
juggalo	juggalo
welfare	welfare
Liberal	L!beral
Torture	Torture
Whigger	Wh!gger
Pindick	P!nd!ck
Quashie	Quash!e
quashie	quash!e
Phuking	Phuk!ng
asshole	asshole
Quickie	Qu!ck!e
bastard	bastard
Felatio	Felat!o
Wetback	Wetback
snigger	sn!gger
Sheeney	Sheeney
urinary	ur!nary
Hotdamn	Hotdamn
Felcher	Felcher
Dipshit	D!psh!t
negroes	negroes
titfuck	t!tfuck
whigger	wh!gger
Bollock	Bollock
Servant	Servant
Fuckers	Fuckers
Amateur	Amateur
Swallow	Swallow
Jerkoff	Jerkoff
Welcher	Welcher
Cumming	Cumm!ng
Pissoff	P!ssoff
killing	k!ll!ng
pussies	puss!es
fuckbag	fuckbag
servant	servant
Fairies	Fa!r!es
assault	assault
Pansies	Pans!es
pissing	p!ss!ng
Bumfuck	Bumfuck
Assault	Assault
niggers	n!ggers
Dickman	D!ckman
Puddboy	Puddboy
baptist	bapt!st
Cumquat	Cumquat
lesbayn	lesbayn
Buggery	Buggery
jackass	jackass
Analsex	Analsex
Panties	Pant!es
Twinkie	Tw!nk!e
urinate	ur!nate
Radical	Rad!cal
Rimming	R!mm!ng
skumbag	skumbag
Disease	D!sease
negroid	negro!d
Bondage	Bondage
bumfuck	bumfuck
Vaginal	Vag!nal
carruth	carruth
analsex	analsex
Shitcan	Sh!tcan
mulatto	mulatto
swallow	swallow
rearend	rearend
Shitola	Sh!tola
Goddamn	Goddamn
remains	rema!ns
Refugee	Refugee
Lactate	Lactate
Kumming	Kumm!ng
Jigaboo	J!gaboo
lovegun	lovegun
rimming	r!mm!ng
Colored	Colored
Shiting	Sh!t!ng
Crapper	Crapper
dickwad	d!ckwad
niggles	n!ggles
Redneck	Redneck
goddamn	goddamn
asshore	asshore
tarbaby	tarbaby
buggery	buggery
whacker	whacker
Bitchez	B!tchez
Triplex	Tr!plex
Fuckbag	Fuckbag
strapon	strapon
niggled	n!ggled
amateur	amateur
shitted	sh!tted
gangsta	gangsta
Baptist	Bapt!st
muncher	muncher
Fuckina	Fuck!na
Shaggin	Shagg!n
triplex	tr!plex
Jiggabo	J!ggabo
honkers	honkers
cocaine	coca!ne
Beatoff	Beatoff
Russkie	Russk!e
dipshit	d!psh!t
Asslick	Assl!ck
badfuck	badfuck
Farting	Fart!ng
mexican	mex!can
Coondog	Coondog
genital	gen!tal
torture	torture
Fisting	F!st!ng
russkie	russk!e
disease	d!sease
suicide	su!c!de
bollick	boll!ck
lesbain	lesba!n
Fuckyou	Fuckyou
Wetspot	Wetspot
shitfit	sh!tf!t
Clogwog	Clogwog
bitchin	b!tch!n
Trannie	Trann!e
boobies	boob!es
Mexican	Mex!can
kumming	kumm!ng
puddboy	puddboy
kumquat	kumquat
barface	barface
Juggalo	Juggalo
israeli	!srael!
Barface	Barface
Nastyho	Nastyho
Penises	Pen!ses
reestie	reest!e
phukked	phukked
Spitter	Sp!tter
pansies	pans!es
Cocaine	Coca!ne
Illegal	Illegal
Vatican	Vat!can
Honkers	Honkers
Execute	Execute
asswipe	assw!pe
slapper	slapper
Suckoff	Suckoff
clogwog	clogwog
Asshore	Asshore
fuckers	fuckers
Shinola	Sh!nola
Hooters	Hooters
Negroes	Negroes
quickie	qu!ck!e
Sextoys	Sextoys
Fagging	Fagg!ng
penises	pen!ses
Urinate	Ur!nate
lowlife	lowl!fe
Israeli	Israel!
Cumshot	Cumshot
Strapon	Strapon
welcher	welcher
Niggles	N!ggles
kissass	k!ssass
Drunken	Drunken
shiting	sh!t!ng
Lovegun	Lovegun
Lubejob	Lubejob
Titties	T!tt!es
Fuckoff	Fuckoff
titties	t!tt!es
Gangsta	Gangsta
wanking	wank!ng
phuking	phuk!ng
bondage	bondage
bigbutt	b!gbutt
fuckyou	fuckyou
Lesbian	Lesb!an
shinola	sh!nola
bitcher	b!tcher
handjob	handjob
doo-doo	doo-doo
funeral	funeral
Orgasim	Orgas!m
Fatfuck	Fatfuck
sextogo	sextogo
Snigger	Sn!gger
Blowjob	Blowjob
Wanking	Wank!ng
pindick	p!nd!ck
Kumquat	Kumquat
Hiscock	H!scock
Welfare	Welfare
Bitchin	B!tch!n
Funeral	Funeral
Brothel	Brothel
brothel	brothel
Carruth	Carruth
bollock	bollock
Addicts	Add!cts
Jackoff	Jackoff
orgasim	orgas!m
Tarbaby	Tarbaby
assfuck	assfuck
jigaboo	j!gaboo
hosejob	hosejob
Niggard	N!ggard
Buttman	Buttman
Rearend	Rearend
Hosejob	Hosejob
playboy	playboy
mideast	m!deast
puntang	puntang
phungky	phungky
Deposit	Depos!t
Skumbag	Skumbag
bitches	b!tches
Schlong	Schlong
Bestial	Best!al
Hookers	Hookers
Remains	Rema!ns
shaggin	shagg!n
spitter	sp!tter
livesex	l!vesex
Muncher	Muncher
Livesex	L!vesex
Whiskey	Wh!skey
scrotum	scrotum
jimfish	j!mf!sh
Aroused	Aroused
Jimfish	J!mf!sh
asslick	assl!ck
Lesbayn	Lesbayn
Ecstacy	Ecstacy
Pussies	Puss!es
Pooping	Poop!ng
ecstacy	ecstacy
Lowlife	Lowl!fe
trannie	trann!e
women's	women's
Jackass	Jackass
Pee-pee	Pee-pee
vatican	vat!can
Slapper	Slapper
asskiss	assk!ss
Niggers	N!ggers
Asshole	Asshole
Fuckher	Fuckher
Puntang	Puntang
fairies	fa!r!es
cumming	cumm!ng
addicts	add!cts
cumquat	cumquat
Kissass	K!ssass
whiskey	wh!skey
jackoff	jackoff
Hostage	Hostage
illegal	!llegal
fucking	fuck!ng
hostage	hostage
shitter	sh!tter
cumfest	cumfest
Whacker	Whacker
crapper	crapper
Boobies	Boob!es
sheeney	sheeney
pissoff	p!ssoff
schlong	schlong
bombing	bomb!ng
fuckina	fuck!na
chinese	ch!nese
Cumfest	Cumfest
fuckoff	fuckoff
getiton	get!ton
Niggled	N!ggled
waysted	waysted
Mideast	M!deast
hooters	hooters
lovegoo	lovegoo
bestial	best!al
Banging	Bang!ng
Phukked	Phukked
Cocknob	Cocknob
Dumbass	Dumbass
bombers	bombers
Handjob	Handjob
Women's	Women's
Raghead	Raghead
hustler	hustler
Waysted	Waysted
bazooms	bazooms
dickman	d!ckman
Titfuck	T!tfuck
Badfuck	Badfuck
sextoys	sextoys
raghead	raghead
Bazooms	Bazooms
Bollick	Boll!ck
Playboy	Playboy
wetspot	wetspot
vaginal	vag!nal
twinkie	tw!nk!e
Sexfarm	Sexfarm
Shitfit	Sh!tf!t
coondog	coondog
Phungky	Phungky
African	Afr!can
hookers	hookers
blowjob	blowjob
Negro's	Negro's
felatio	felat!o
nastyho	nastyho
deposit	depos!t
Bombers	Bombers
panties	pant!es
fatfuck	fatfuck
felcher	felcher
aroused	aroused
Asskiss	Assk!ss
Shitted	Sh!tted
Negroid	Negro!d
Chinese	Ch!nese
redneck	redneck
Scrotum	Scrotum
fuckher	fuckher
Bitches	B!tches
Getiton	Get!ton
funfuck	funfuck
upskirt	upsk!rt
jerkoff	jerkoff
Destroy	Destroy
Fucking	Fuck!ng
shitola	sh!tola
fisting	f!st!ng
Killing	K!ll!ng
refugee	refugee
lactate	lactate
beatoff	beatoff
shitcan	sh!tcan
Poverty	Poverty
failure	fa!lure
Bigbutt	B!gbutt
lubejob	lubejob
Fuckpig	Fuckp!g
suckoff	suckoff
pee-pee	pee-pee
execute	execute
wetback	wetback
african	afr!can
Asswipe	Assw!pe
Hustler	Hustler
farting	fart!ng
radical	rad!cal
peehole	peehole
destroy	destroy
cocknob	cocknob
flasher	flasher
Japcrap	Japcrap
buttman	buttman
Failure	Fa!lure
Dickwad	D!ckwad
crapola	crapola
hiscock	h!scock
banging	bang!ng
Doo-doo	Doo-doo
Crapola	Crapola
Assfuck	Assfuck
Flasher	Flasher
Sextogo	Sextogo
fuckpig	fuckp!g
Upskirt	Upsk!rt
Areola	Areola
Racial	Rac!al
escort	escort
pistol	p!stol
Tortur	Tortur
nookie	nook!e
Gyppie	Gypp!e
krappy	krappy
Babies	Bab!es
robber	robber
Africa	Afr!ca
Nooner	Nooner
Incest	Incest
nudger	nudger
fuckit	fuck!t
chinky	ch!nky
Failed	Fa!led
Tittie	T!tt!e
Slopey	Slopey
Kanake	Kanake
Iblowu	Iblowu
Gringo	Gr!ngo
pommie	pomm!e
Pooper	Pooper
Hummer	Hummer
Tantra	Tantra
moslem	moslem
firing	f!r!ng
shited	sh!ted
retard	retard
kondum	kondum
Noonan	Noonan
dammit	damm!t
Toilet	To!let
mockie	mock!e
rectum	rectum
weapon	weapon
Zigabo	Z!gabo
pisser	p!sser
pecker	pecker
Tosser	Tosser
feltch	feltch
Escort	Escort
niggor	n!ggor
Nudger	Nudger
sniper	sn!per
Darkie	Dark!e
kigger	k!gger
period	per!od
Kigger	K!gger
gringo	gr!ngo
killed	k!lled
nittit	n!tt!t
Swalow	Swalow
Wanker	Wanker
tortur	tortur
darkie	dark!e
Weenie	Ween!e
Farted	Farted
Fister	F!ster
soviet	sov!et
spunky	spunky
hitler	h!tler
suckme	suckme
dahmer	dahmer
Sucker	Sucker
Rapist	Rap!st
turnon	turnon
Hijack	H!jack
gummer	gummer
bigger	b!gger
hooker	hooker
Pudboy	Pudboy
skanky	skanky
Jizzum	J!zzum
Dahmer	Dahmer
stiffy	st!ffy
Mormon	Mormon
crappy	crappy
Pimped	P!mped
Wigger	W!gger
horney	horney
Tampon	Tampon
flydye	flydye
reefer	reefer
Orgasm	Orgasm
Turnon	Turnon
Slutty	Slutty
diddle	d!ddle
Feltch	Feltch
willie	w!ll!e
creamy	creamy
liquor	l!quor
Israel	Israel
whitey	wh!tey
honger	honger
Titjob	T!tjob
niggur	n!ggur
Rectum	Rectum
Nignog	N!gnog
Attack	Attack
faggot	faggot
wanker	wanker
Commie	Comm!e
Stroke	Stroke
Christ	Chr!st
Period	Per!od
Condom	Condom
Liquor	L!quor
Addict	Add!ct
sexpot	sexpot
Hodgie	Hodg!e
bugger	bugger
Vagina	Vag!na
Reefer	Reefer
slutty	slutty
Creamy	Creamy
popimp	pop!mp
Looser	Looser
coitus	co!tus
titjob	t!tjob
Hooker	Hooker
Chinky	Ch!nky
breast	breast
Sexpot	Sexpot
Nookie	Nook!e
Phuked	Phuked
insest	!nsest
orgasm	orgasm
Krappy	Krappy
pisses	p!sses
Tranny	Tranny
faeces	faeces
yankee	yankee
Molest	Molest
farted	farted
sucker	sucker
beaver	beaver
Racist	Rac!st
Assman	Assman
virgin	v!rg!n
Asshat	Asshat
Geezer	Geezer
tosser	tosser
jigger	j!gger
kaffir	kaff!r
Orgies	Org!es
Cacker	Cacker
herpes	herpes
iblowu	!blowu
biatch	b!atch
Pissed	P!ssed
blacks	blacks
Mockie	Mock!e
Lotion	Lot!on
pissed	p!ssed
toilet	to!let
Killed	K!lled
Hitler	H!tler
Nigger	N!gger
dyefly	dyefly
polack	polack
reject	reject
Kaffre	Kaffre
looser	looser
Niggle	N!ggle
hummer	hummer
sextoy	sextoy
Tinkle	T!nkle
fckcum	fckcum
Dyefly	Dyefly
Fuckin	Fuck!n
Licker	L!cker
Gaysex	Gaysex
Fondle	Fondle
cacker	cacker
Uterus	Uterus
racist	rac!st
killer	k!ller
Damnit	Damn!t
Sexual	Sexual
weenie	ween!e
pimped	p!mped
Fungus	Fungus
Fuckme	Fuckme
noonan	noonan
German	German
Nookey	Nookey
terror	terror
kanake	kanake
Fucked	Fucked
fuckin	fuck!n
Niggur	N!ggur
tinkle	t!nkle
Sniper	Sn!per
nooner	nooner
honkey	honkey
Ethnic	Ethn!c
Pisses	P!sses
Diddle	D!ddle
molest	molest
byatch	byatch
nipple	n!pple
sexing	sex!ng
Bugger	Bugger
Reject	Reject
fucked	fucked
Weewee	Weewee
Coitus	Co!tus
Fetish	Fet!sh
lotion	lot!on
fatass	fatass
Flange	Flange
tittie	t!tt!e
Pissin	P!ss!n
Robber	Robber
doodoo	doodoo
Willie	W!ll!e
babies	bab!es
pimper	p!mper
stupid	stup!d
jizzim	j!zz!m
licker	l!cker
Pistol	P!stol
Pisser	P!sser
commie	comm!e
attack	attack
hindoo	h!ndoo
Ribbed	R!bbed
Gummer	Gummer
Rimjob	R!mjob
Hardon	Hardon
Polack	Polack
Boonie	Boon!e
Retard	Retard
Stiffy	St!ffy
sodomy	sodomy
flange	flange
Niggah	N!ggah
lesbin	lesb!n
Niglet	N!glet
zigabo	z!gabo
Fatass	Fatass
biteme	b!teme
Libido	L!b!do
Macaca	Macaca
nlggor	nlggor
Boonga	Boonga
hardon	hardon
gaysex	gaysex
addict	add!ct
muslim	musl!m
Niggaz	N!ggaz
Lolita	Lol!ta
Cunntt	Cunntt
cummer	cummer
fuckme	fuckme
coolie	cool!e
Murder	Murder
hijack	h!jack
Weapon	Weapon
kummer	kummer
Heroin	Hero!n
desire	des!re
Nlgger	Nlgger
Crappy	Crappy
Spooge	Spooge
rapist	rap!st
Virgin	V!rg!n
areola	areola
libido	l!b!do
Desire	Des!re
Spunky	Spunky
Bitchy	B!tchy
fucker	fucker
kaffre	kaffre
Snatch	Snatch
swalow	swalow
Nlggor	Nlggor
kaffer	kaffer
Suckme	Suckme
tantra	tantra
Faggot	Faggot
tampon	tampon
wigger	w!gger
Beaner	Beaner
Bigass	B!gass
Harder	Harder
Honkey	Honkey
russki	russk!
Pecker	Pecker
condom	condom
christ	chr!st
Beaver	Beaver
Crotch	Crotch
Pimper	P!mper
Biatch	B!atch
pussie	puss!e
Breast	Breast
boonga	boonga
Cancer	Cancer
Pussie	Puss!e
Mockey	Mockey
Killer	K!ller
Jigger	J!gger
lickme	l!ckme
Whites	Wh!tes
german	german
Horney	Horney
israel	!srael
Muslim	Musl!m
ethnic	ethn!c
Hindoo	H!ndoo
Fucker	Fucker
snatch	snatch
racial	rac!al
buried	bur!ed
brea5t	brea5t
Doodoo	Doodoo
Niggor	N!ggor
mormon	mormon
Faeces	Faeces
tranny	tranny
Lesbin	Lesb!n
bohunk	bohunk
Yankee	Yankee
Wuzzie	Wuzz!e
vagina	vag!na
Shited	Sh!ted
nignog	n!gnog
Fckcum	Fckcum
lolita	lol!ta
nigger	n!gger
niglet	n!glet
Insest	Insest
Cummer	Cummer
church	church
Flydye	Flydye
asshat	asshat
Trojan	Trojan
Sexing	Sex!ng
crimes	cr!mes
Russki	Russk!
mockey	mockey
crotch	crotch
Blacks	Blacks
Herpes	Herpes
Honger	Honger
Fuckit	Fuck!t
hodgie	hodg!e
Sodomy	Sodomy
Nittit	N!tt!t
heroin	hero!n
Church	Church
Buried	Bur!ed
Shitty	Sh!tty
fungus	fungus
wuzzie	wuzz!e
rigger	r!gger
Coolie	Cool!e
damnit	damn!t
Kaffir	Kaff!r
orgies	org!es
Penile	Pen!le
rimjob	r!mjob
trojan	trojan
penile	pen!le
Kaffer	Kaffer
shitty	sh!tty
Whitey	Wh!tey
fister	f!ster
Popimp	Pop!mp
Stupid	Stup!d
phuked	phuked
jizzum	j!zzum
niggle	n!ggle
sexual	sexual
macaca	macaca
Firing	F!r!ng
beaner	beaner
jewish	jew!sh
Sextoy	Sextoy
ribbed	r!bbed
geezer	geezer
tongue	tongue
murder	murder
boonie	boon!e
Lickme	L!ckme
Tongue	Tongue
Kummer	Kummer
Jewish	Jew!sh
Flydie	Flyd!e
nookey	nookey
niggah	n!ggah
incest	!ncest
whites	wh!tes
Nipple	N!pple
africa	afr!ca
Moslem	Moslem
Kondum	Kondum
Terror	Terror
bigass	b!gass
weewee	weewee
Soviet	Sov!et
niggaz	n!ggaz
failed	fa!led
Pommie	Pomm!e
Crimes	Cr!mes
nlgger	nlgger
Biteme	B!teme
fetish	fet!sh
Bigger	B!gger
uterus	uterus
slopey	slopey
Dammit	Damm!t
Rigger	R!gger
cancer	cancer
Skanky	Skanky
Brea5t	Brea5t
Byatch	Byatch
spooge	spooge
pissin	p!ss!n
cunntt	cunntt
pooper	pooper
Bohunk	Bohunk
assman	assman
pudboy	pudboy
gyppie	gypp!e
bitchy	b!tchy
Jizzim	J!zz!m
fondle	fondle
harder	harder
stroke	stroke
flydie	flyd!e
bogan	bogan
booby	booby
darky	darky
Taboo	Taboo
loser	loser
Moron	Moron
kills	k!lls
Moles	Moles
Devil	Dev!l
hoser	hoser
Pixie	P!x!e
faith	fa!th
enemy	enemy
Lynch	Lynch
Roach	Roach
Piker	P!ker
Forni	Forn!
bible	b!ble
negro	negro
balls	balls
ginzo	g!nzo
Smack	Smack
sooty	sooty
Titty	T!tty
Porno	Porno
Vulva	Vulva
fatah	fatah
urine	ur!ne
cooly	cooly
Dildo	D!ldo
Teste	Teste
Slave	Slave
fucks	fucks
Crabs	Crabs
Rabbi	Rabb!
fight	f!ght
Loser	Loser
Negro	Negro
pixie	p!x!e
Fraud	Fraud
Boobs	Boobs
Girls	G!rls
Boody	Boody
Fubar	Fubar
Chode	Chode
Fight	F!ght
moron	moron
fraud	fraud
Pocho	Pocho
lezbo	lezbo
Honky	Honky
gross	gross
Idiot	Id!ot
boang	boang
beast	beast
sexed	sexed
Sandm	Sandm
choad	choad
kotex	kotex
shits	sh!ts
panti	pant!
Semen	Semen
shite	sh!te
screw	screw
Death	Death
Asian	As!an
Pikey	P!key
sandm	sandm
fucck	fucck
Angie	Ang!e
pu55y	pu55y
crash	crash
Whash	Whash
trots	trots
niger	n!ger
black	black
slopy	slopy
fagot	fagot
naked	naked
Raped	Raped
taboo	taboo
bombs	bombs
Gyppo	Gyppo
feces	feces
whash	whash
Boang	Boang
Color	Color
usama	usama
Latin	Lat!n
Ginzo	G!nzo
Hymie	Hym!e
mgger	mgger
Harem	Harem
Kafir	Kaf!r
Whore	Whore
Kraut	Kraut
shhit	shh!t
lezzo	lezzo
Drunk	Drunk
Naked	Naked
fugly	fugly
enema	enema
Hamas	Hamas
Slant	Slant
abuse	abuse
Spank	Spank
goyim	goy!m
slutt	slutt
Hoser	Hoser
Spunk	Spunk
cra5h	cra5h
sissy	s!ssy
hamas	hamas
Lesbo	Lesbo
lynch	lynch
Sodom	Sodom
Slutt	Slutt
hussy	hussy
Necro	Necro
Nymph	Nymph
Sperm	Sperm
raped	raped
Shits	Sh!ts
Cohee	Cohee
Fugly	Fugly
boody	boody
Husky	Husky
boobs	boobs
Fuuck	Fuuck
mggor	mggor
Angry	Angry
Fairy	Fa!ry
Usama	Usama
piker	p!ker
Nigga	N!gga
Goyim	Goy!m
chode	chode
Raper	Raper
Vomit	Vom!t
pocho	pocho
Shite	Sh!te
stagg	stagg
Willy	W!lly
gubba	gubba
Lugan	Lugan
mafia	maf!a
slave	slave
pansy	pansy
Spick	Sp!ck
Cooly	Cooly
dirty	d!rty
Pussy	Pussy
semen	semen
pendy	pendy
Stagg	Stagg
lezbe	lezbe
Fucck	Fucck
Pubic	Pub!c
queef	queef
Lezbo	Lezbo
Pendy	Pendy
Felch	Felch
Penis	Pen!s
Eatme	Eatme
Sadis	Sad!s
Horny	Horny
husky	husky
Enemy	Enemy
spick	sp!ck
Sadom	Sadom
girls	g!rls
Crash	Crash
harem	harem
Arabs	Arabs
fatso	fatso
Screw	Screw
Gyppy	Gyppy
Lezbe	Lezbe
jebus	jebus
Jizim	J!z!m
Booty	Booty
jiggy	j!ggy
Urine	Ur!ne
Fatso	Fatso
jesus	jesus
Boong	Boong
Abuse	Abuse
Fucka	Fucka
jigga	j!gga
Farty	Farty
Mocky	Mocky
nigga	n!gga
willy	w!lly
Queef	Queef
osama	osama
sodom	sodom
horny	horny
Seppo	Seppo
arabs	arabs
Kills	K!lls
tramp	tramp
raper	raper
Feces	Feces
twink	tw!nk
pommy	pommy
Nasty	Nasty
spunk	spunk
vulva	vulva
spank	spank
Queer	Queer
Beast	Beast
Randy	Randy
squaw	squaw
Choad	Choad
boner	boner
asian	as!an
hymie	hym!e
penis	pen!s
Jigga	J!gga
fucka	fucka
Sissy	S!ssy
Allah	Allah
bitch	b!tch
Fucks	Fucks
Fatah	Fatah
Tramp	Tramp
color	color
kinky	k!nky
Hymen	Hymen
Black	Black
Fagot	Fagot
kafir	kaf!r
adult	adult
Nigre	N!gre
skank	skank
angie	ang!e
Pu55i	Pu55!
lugan	lugan
Slopy	Slopy
Bogan	Bogan
Mggor	Mggor
Pu55y	Pu55y
crime	cr!me
Knife	Kn!fe
felch	felch
drunk	drunk
cocky	cocky
smack	smack
demon	demon
seppo	seppo
Kinky	K!nky
kraut	kraut
sadis	sad!s
Cra5h	Cra5h
sadom	sadom
allah	allah
Trots	Trots
fubar	fubar
peni5	pen!5
pu55i	pu55!
whore	whore
Peni5	Pen!5
Bombs	Bombs
Lezzo	Lezzo
teste	teste
roach	roach
joint	jo!nt
eatme	eatme
Bunga	Bunga
dildo	d!ldo
hymen	hymen
Shoot	Shoot
angry	angry
Sluts	Sluts
Pommy	Pommy
farty	farty
fuuck	fuuck
death	death
vomit	vom!t
Shhit	Shh!t
argie	arg!e
Twink	Tw!nk
Panti	Pant!
jizim	j!z!m
pikey	p!key
Cocky	Cocky
Sexed	Sexed
slime	sl!me
Nigra	N!gra
Booby	Booby
Joint	Jo!nt
nigra	n!gra
crabs	crabs
crack	crack
porno	porno
Argie	Arg!e
knife	kn!fe
Chink	Ch!nk
Blind	Bl!nd
Crack	Crack
Kotex	Kotex
Crime	Cr!me
Squaw	Squaw
Prick	Pr!ck
pocha	pocha
nasty	nasty
nigre	n!gre
gyppy	gyppy
Erect	Erect
Jebus	Jebus
Demon	Demon
queer	queer
Niger	N!ger
bunga	bunga
pussy	pussy
randy	randy
Enema	Enema
Gross	Gross
Limey	L!mey
fairy	fa!ry
Balls	Balls
rabbi	rabb!
honky	honky
Jiggy	J!ggy
forni	forn!
slant	slant
boong	boong
Asses	Asses
Bible	B!ble
Mafia	Maf!a
mocky	mocky
moles	moles
Jesus	Jesus
Dirty	D!rty
asses	asses
limey	l!mey
Gubba	Gubba
Darky	Darky
Pocha	Pocha
prick	pr!ck
idiot	!d!ot
Bitch	B!tch
erect	erect
jihad	j!had
Hussy	Hussy
Faith	Fa!th
titty	t!tty
Satan	Satan
devil	dev!l
blind	bl!nd
necro	necro
Slime	Sl!me
Osama	Osama
satan	satan
booty	booty
pubic	pub!c
Adult	Adult
sluts	sluts
cohee	cohee
gyppo	gyppo
latin	lat!n
Boner	Boner
Jihad	J!had
Pansy	Pansy
Skank	Skank
Mgger	Mgger
Sooty	Sooty
shoot	shoot
sperm	sperm
nymph	nymph
lesbo	lesbo
chink	ch!nk
ikey	!key
jigg	j!gg
bomd	bomd
Hell	Hell
Paki	Pak!
Skum	Skum
Nook	Nook
Anal	Anal
dope	dope
Rere	Rere
Hoes	Hoes
turd	turd
Fore	Fore
meth	meth
fuck	fuck
scum	scum
Piky	P!ky
whiz	wh!z
Piss	P!ss
tard	tard
bast	bast
cunt	cunt
nazi	naz!
mams	mams
Hole	Hole
Pimp	P!mp
Nuke	Nuke
Cock	Cock
Babe	Babe
Slut	Slut
Fear	Fear
abbo	abbo
spig	sp!g
pimp	p!mp
jism	j!sm
rere	rere
kunt	kunt
scag	scag
slav	slav
hork	hork
orga	orga
Wank	Wank
Pube	Pube
laid	la!d
Pric	Pr!c
Arab	Arab
Kink	K!nk
peck	peck
Mofo	Mofo
Pixy	P!xy
cock	cock
Floo	Floo
dong	dong
skum	skum
Jizm	J!zm
groe	groe
muff	muff
pohm	pohm
krap	krap
Jism	J!sm
shav	shav
Spig	Sp!g
Koon	Koon
Dead	Dead
Pi55	P!55
Cunt	Cunt
Lies	L!es
chav	chav
Moky	Moky
boom	boom
jiga	j!ga
Dike	D!ke
Sexy	Sexy
Gypo	Gypo
Nazi	Naz!
Butt	Butt
gypo	gypo
pixy	p!xy
Doom	Doom
cumm	cumm
teat	teat
blow	blow
hore	hore
heeb	heeb
jugs	jugs
phuq	phuq
cigs	c!gs
Hore	Hore
Bong	Bong
hebe	hebe
phuk	phuk
Arse	Arse
snot	snot
butt	butt
alla	alla
pric	pr!c
Porn	Porn
jizm	j!zm
Drug	Drug
oral	oral
Poop	Poop
Tard	Tard
Burn	Burn
Died	D!ed
piss	p!ss
Perv	Perv
Fire	F!re
poon	poon
doom	doom
Jade	Jade
Jigg	J!gg
Kill	K!ll
Pros	Pros
Poon	Poon
Blow	Blow
damn	damn
dago	dago
kums	kums
vibr	v!br
Puss	Puss
Shat	Shat
Crap	Crap
Tits	T!ts
Clit	Cl!t
shag	shag
hell	hell
bomb	bomb
dumb	dumb
Munt	Munt
tits	t!ts
Wetb	Wetb
fear	fear
nude	nude
jizz	j!zz
anus	anus
Meth	Meth
Gook	Gook
Dink	D!nk
boob	boob
spik	sp!k
Geez	Geez
Lezz	Lezz
Honk	Honk
kike	k!ke
Dyke	Dyke
Taff	Taff
nook	nook
Phuq	Phuq
kill	k!ll
Scat	Scat
Dago	Dago
slut	slut
milf	m!lf
Shav	Shav
Hebe	Hebe
whop	whop
spic	sp!c
wetb	wetb
Slav	Slav
porn	porn
scat	scat
Homo	Homo
drug	drug
Whiz	Wh!z
Dive	D!ve
dego	dego
barf	barf
payo	payo
lies	l!es
Horn	Horn
Shag	Shag
Hapa	Hapa
Jeez	Jeez
pi55	p!55
puss	puss
Spit	Sp!t
Cigs	C!gs
whit	wh!t
ra8s	ra8s
Jizz	J!zz
perv	perv
died	d!ed
Spik	Sp!k
Pusy	Pusy
honk	honk
Groe	Groe
rump	rump
shit	sh!t
Krap	Krap
Limy	L!my
nigr	n!gr
Oral	Oral
dyke	dyke
dead	dead
Hobo	Hobo
Chav	Chav
Boom	Boom
Shit	Sh!t
Kock	Kock
fart	fart
Dick	D!ck
poop	poop
Dumb	Dumb
geni	gen!
hoes	hoes
mofo	mofo
Whit	Wh!t
pube	pube
Kyke	Kyke
fuks	fuks
dick	d!ck
orgy	orgy
Nigg	N!gg
burn	burn
Kums	Kums
spit	sp!t
anal	anal
hole	hole
twat	twat
piky	p!ky
Suck	Suck
Tang	Tang
Heeb	Heeb
taff	taff
arab	arab
tang	tang
Nude	Nude
babe	babe
nuke	nuke
Vibr	V!br
wuss	wuss
Dies	D!es
pusy	pusy
fore	fore
moky	moky
Dong	Dong
Smut	Smut
Nigr	N!gr
cunn	cunn
Coon	Coon
gypp	gypp
kink	k!nk
Laid	La!d
jeez	jeez
sick	s!ck
koon	koon
puke	puke
arse	arse
Sick	S!ck
Payo	Payo
Milf	M!lf
hobo	hobo
Pudd	Pudd
Itch	Itch
Cumm	Cumm
Scag	Scag
Dego	Dego
Kike	K!ke
suck	suck
horn	horn
Orgy	Orgy
pros	pros
lezz	lezz
Anus	Anus
Dope	Dope
munt	munt
Barf	Barf
Cunn	Cunn
Fart	Fart
Twat	Twat
Ikey	Ikey
Whop	Whop
Jugs	Jugs
Turd	Turd
Jiga	J!ga
Peck	Peck
hapa	hapa
Phuk	Phuk
Gipp	G!pp
Puke	Puke
Ra8s	Ra8s
paki	pak!
dies	d!es
limy	l!my
deth	deth
Muff	Muff
Quim	Qu!m
Hook	Hook
Bomb	Bomb
Wuss	Wuss
Scum	Scum
Chin	Ch!n
Spic	Sp!c
Boob	Boob
fire	f!re
hook	hook
dike	d!ke
kock	kock
nigg	n!gg
coon	coon
sexy	sexy
Rump	Rump
Fuck	Fuck
clit	cl!t
Fuks	Fuks
dink	d!nk
shat	shat
kyke	kyke
smut	smut
floo	floo
Deth	Deth
chin	ch!n
Orga	Orga
Abbo	Abbo
pudd	pudd
itch	!tch
Rape	Rape
jade	jade
gook	gook
Bomd	Bomd
Damn	Damn
Alla	Alla
Snot	Snot
wank	wank
Bast	Bast
rape	rape
homo	homo
crap	crap
quim	qu!m
Pohm	Pohm
Kunt	Kunt
bong	bong
dive	d!ve
Teat	Teat
Hork	Hork
Geni	Gen!
Mams	Mams
geez	geez
gipp	g!pp
Gypp	Gypp
jew	jew
Uck	Uck
jiz	j!z
gob	gob
Pud	Pud
sob	sob
God	God
sex	sex
Ass	Ass
pot	pot
Xxx	Xxx
Poo	Poo
dix	d!x
nip	n!p
Wog	Wog
kkk	kkk
nig	n!g
Goy	Goy
gin	g!n
poo	poo
Sob	Sob
Fuc	Fuc
Xtc	Xtc
wop	wop
Gay	Gay
pee	pee
Dix	D!x
Jew	Jew
wab	wab
Mad	Mad
pud	pud
ero	ero
Sex	Sex
fat	fat
hiv	h!v
Evl	Evl
jap	jap
tnt	tnt
Tit	T!t
gun	gun
wtf	wtf
Pom	Pom
Lez	Lez
Gob	Gob
goy	goy
Fuk	Fuk
uck	uck
Fat	Fat
bra	bra
Tnt	Tnt
cum	cum
wog	wog
ass	ass
Kkk	Kkk
Pee	Pee
Jap	Jap
Abo	Abo
Cum	Cum
Nip	N!p
sos	sos
pom	pom
xtc	xtc
tit	t!t
Gyp	Gyp
fuk	fuk
evl	evl
xxx	xxx
Gun	Gun
Kid	K!d
fok	fok
mad	mad
Sos	Sos
Fok	Fok
Gin	G!n
kum	kum
Fag	Fag
Wab	Wab
abo	abo
die	d!e
kid	k!d
gyp	gyp
Hiv	H!v
lsd	lsd
gay	gay
god	god
Nig	N!g
Bra	Bra
Jiz	J!z
Pot	Pot
Wop	Wop
Kum	Kum
Lsd	Lsd
lez	lez
fag	fag
Wtf	Wtf
fuc	fuc
Ero	Ero
Die	D!e
uk	uk
wn	wn
ho	ho
ky	ky
Wn	Wn
Uk	Uk
fu	fu
Ky	Ky
bi	b!
Bi	B!
Ho	Ho
Fu	Fu
