original	new
Gaymuthafuckinwhore	Gaymuthafuckinwhore.
gaymuthafuckinwhore	gaymuthafuckinwhore.
Goddamnmuthafucker	Goddamnmuthafucker.
goddamnmuthafucker	goddamnmuthafucker.
mattressprincess	mattressprincess.
Mattressprincess	Mattressprincess.
spaghettibender	spaghettibender.
spaghettinigger	spaghettinigger.
Spaghettibender	Spaghettibender.
devilworshipper	devilworshipper.
niggardliness's	niggardliness's.
Spaghettinigger	Spaghettinigger.
Devilworshipper	Devilworshipper.
Niggardliness's	Niggardliness's.
Motherfuckings	Motherfuckings.
Poorwhitetrash	Poorwhitetrash.
spankthemonkey	spankthemonkey.
smackthemonkey	smackthemonkey.
purinapricness	purinapricness.
Motherlovebone	Motherlovebone.
Luckycammeltoe	Luckycammeltoe.
Purinapricness	Purinapricness.
motherfuckings	motherfuckings.
motherlovebone	motherlovebone.
Spankthemonkey	Spankthemonkey.
poorwhitetrash	poorwhitetrash.
Smackthemonkey	Smackthemonkey.
luckycammeltoe	luckycammeltoe.
Alligatorbait	Alligatorbait.
jacktheripper	jacktheripper.
Tongethruster	Tongethruster.
Carpetmuncher	Carpetmuncher.
shitforbrains	shitforbrains.
fingerfucking	fingerfucking.
Motherfucking	Motherfucking.
pooperscooper	pooperscooper.
Masterblaster	Masterblaster.
dickforbrains	dickforbrains.
Jacktheripper	Jacktheripper.
Fingerfuckers	Fingerfuckers.
fingerfuckers	fingerfuckers.
Pooperscooper	Pooperscooper.
Fingerfucking	Fingerfucking.
niggardliness	niggardliness.
carpetmuncher	carpetmuncher.
virginbreaker	virginbreaker.
Shitforbrains	Shitforbrains.
pearlnecklace	pearlnecklace.
Virginbreaker	Virginbreaker.
Assassination	Assassination.
shitoutofluck	shitoutofluck.
Niggardliness	Niggardliness.
assassination	assassination.
tongethruster	tongethruster.
Mothafuckings	Mothafuckings.
mothafuckings	mothafuckings.
Shitoutofluck	Shitoutofluck.
masterblaster	masterblaster.
alligatorbait	alligatorbait.
Dickforbrains	Dickforbrains.
motherfucking	motherfucking.
Pearlnecklace	Pearlnecklace.
Pussypounder	Pussypounder.
Heterosexual	Heterosexual.
transvestite	transvestite.
freakyfucker	freakyfucker.
Conservative	Conservative.
masturbating	masturbating.
Fingerfucked	Fingerfucked.
motherfucker	motherfucker.
Transvestite	Transvestite.
Pornprincess	Pornprincess.
pussypounder	pussypounder.
pornprincess	pornprincess.
Cherrypopper	Cherrypopper.
motherfucked	motherfucked.
Mothafucking	Mothafucking.
grostulation	grostulation.
Goldenshower	Goldenshower.
fingerfucker	fingerfucker.
Fuckingbitch	Fuckingbitch.
Titbitnipply	Titbitnipply.
crotchmonkey	crotchmonkey.
tunneloflove	tunneloflove.
Timbernigger	Timbernigger.
Spermhearder	Spermhearder.
Motherfuckin	Motherfuckin.
crotchjockey	crotchjockey.
Trailertrash	Trailertrash.
Motherfucker	Motherfucker.
Motherfucked	Motherfucked.
williewanker	williewanker.
Fingerfucker	Fingerfucker.
fingerfucked	fingerfucked.
trailertrash	trailertrash.
Tunneloflove	Tunneloflove.
tonguethrust	tonguethrust.
motherfuckin	motherfuckin.
Masturbating	Masturbating.
Crotchmonkey	Crotchmonkey.
butt-fuckers	butt-fuckers.
mothafucking	mothafucking.
goldenshower	goldenshower.
stupidfucker	stupidfucker.
Freakyfucker	Freakyfucker.
Stupidfucker	Stupidfucker.
Lezbefriends	Lezbefriends.
athletesfoot	athletesfoot.
Williewanker	Williewanker.
timbernigger	timbernigger.
spermhearder	spermhearder.
fuckingbitch	fuckingbitch.
Athletesfoot	Athletesfoot.
nofuckingway	nofuckingway.
cherrypopper	cherrypopper.
Crotchjockey	Crotchjockey.
beatyourmeat	beatyourmeat.
titbitnipply	titbitnipply.
heterosexual	heterosexual.
Butt-fuckers	Butt-fuckers.
lezbefriends	lezbefriends.
Beatyourmeat	Beatyourmeat.
Nofuckingway	Nofuckingway.
Tonguethrust	Tonguethrust.
Grostulation	Grostulation.
conservative	conservative.
crack-whore	crack-whore.
sonofabitch	sonofabitch.
Mothafuckaz	Mothafuckaz.
Shithappens	Shithappens.
doggiestyle	doggiestyle.
Junglebunny	Junglebunny.
cuntlicking	cuntlicking.
Intercourse	Intercourse.
Twobitwhore	Twobitwhore.
Fudgepacker	Fudgepacker.
tonguetramp	tonguetramp.
pussyfucker	pussyfucker.
homobangers	homobangers.
mothafuckin	mothafuckin.
Butt-fucker	Butt-fucker.
Doggiestyle	Doggiestyle.
mooncricket	mooncricket.
Ejaculating	Ejaculating.
Fistfucking	Fistfucking.
Backdoorman	Backdoorman.
Penetration	Penetration.
Pussyfucker	Pussyfucker.
executioner	executioner.
Crack-whore	Crack-whore.
whiskeydick	whiskeydick.
Whorefucker	Whorefucker.
junglebunny	junglebunny.
Fuckinright	Fuckinright.
spreadeagle	spreadeagle.
Cunillingus	Cunillingus.
Holestuffer	Holestuffer.
Buttfuckers	Buttfuckers.
ejaculation	ejaculation.
Cuntlicking	Cuntlicking.
intercourse	intercourse.
Fannyfucker	Fannyfucker.
Pussylicker	Pussylicker.
porchmonkey	porchmonkey.
Beastiality	Beastiality.
snatchpatch	snatchpatch.
kunnilingus	kunnilingus.
Mothafuckin	Mothafuckin.
beastiality	beastiality.
molestation	molestation.
Whitenigger	Whitenigger.
Molestation	Molestation.
cyberslimer	cyberslimer.
mothafucker	mothafucker.
Buttmuncher	Buttmuncher.
interracial	interracial.
fistfucking	fistfucking.
fudgepacker	fudgepacker.
ejaculating	ejaculating.
whorefucker	whorefucker.
Kunnilingus	Kunnilingus.
Spermherder	Spermherder.
Cunnilingus	Cunnilingus.
Tonguetramp	Tonguetramp.
slimebucket	slimebucket.
cockblocker	cockblocker.
Slimebucket	Slimebucket.
Snatchpatch	Snatchpatch.
Whiskeydick	Whiskeydick.
buttmuncher	buttmuncher.
Cameljockey	Cameljockey.
Dingleberry	Dingleberry.
Mastrabator	Mastrabator.
Glazeddonut	Glazeddonut.
transsexual	transsexual.
Cockblocker	Cockblocker.
shithappens	shithappens.
cunnilingus	cunnilingus.
pussylicker	pussylicker.
palestinian	palestinian.
slavedriver	slavedriver.
Meatbeatter	Meatbeatter.
Executioner	Executioner.
twobitwhore	twobitwhore.
Pornography	Pornography.
butt-fucker	butt-fucker.
cocksucking	cocksucking.
Cocksucking	Cocksucking.
Breastlover	Breastlover.
Ejaculation	Ejaculation.
pornography	pornography.
cameljockey	cameljockey.
whitenigger	
Jesuschrist	Jesuschrist.
Interracial	Interracial.
spermherder	spermherder.
jesuschrist	jesuschrist.
cunillingus	cunillingus.
Mothafucker	Mothafucker.
dingleberry	dingleberry.
mothafuckaz	mothafuckaz.
Sonofabitch	Sonofabitch.
Cyberslimer	Cyberslimer.
Palestinian	Palestinian.
skankybitch	skankybitch.
barelylegal	barelylegal.
mastrabator	mastrabator.
Skankywhore	Skankywhore.
meatbeatter	meatbeatter.
Slavedriver	Slavedriver.
fuckinright	fuckinright.
muffindiver	muffindiver.
Skankybitch	Skankybitch.
Transsexual	Transsexual.
penetration	penetration.
buttfuckers	buttfuckers.
backdoorman	backdoorman.
mothafucked	mothafucked.
breastlover	breastlover.
fannyfucker	fannyfucker.
Hillbillies	Hillbillies.
assassinate	assassinate.
Mothafucked	Mothafucked.
Muffindiver	Muffindiver.
hillbillies	hillbillies.
holestuffer	holestuffer.
Barelylegal	Barelylegal.
Homobangers	Homobangers.
Porchmonkey	Porchmonkey.
glazeddonut	glazeddonut.
skankywhore	skankywhore.
Assassinate	Assassinate.
Mooncricket	Mooncricket.
Spreadeagle	Spreadeagle.
fingerfood	fingerfood.
fuckmehard	fuckmehard.
Deepthroat	Deepthroat.
Mothafucka	Mothafucka.
Transexual	Transexual.
Footaction	Footaction.
Lovemuscle	Lovemuscle.
fingerfuck	fingerfuck.
fistfucked	fistfucked.
deapthroat	deapthroat.
bumblefuck	bumblefuck.
Motherfuck	Motherfuck.
Fuckmehard	Fuckmehard.
nastybitch	nastybitch.
footfucker	footfucker.
Loverocket	Loverocket.
assblaster	assblaster.
Snownigger	Snownigger.
fuckinnuts	fuckinnuts.
pickaninny	pickaninny.
deepthroat	deepthroat.
protestant	protestant.
Butchbabes	Butchbabes.
bestiality	bestiality.
assmuncher	assmuncher.
cuntfucker	cuntfucker.
sandnigger	sandnigger.
masturbate	masturbate.
doggystyle	doggystyle.
Niggarding	Niggarding.
Doggystyle	Doggystyle.
masterbate	masterbate.
Sandnigger	Sandnigger.
Masterbate	Masterbate.
Mufflikcer	Mufflikcer.
Cocksmoker	Cocksmoker.
mufflikcer	mufflikcer.
footlicker	footlicker.
Fourtwenty	Fourtwenty.
Pocketpool	Pocketpool.
flatulence	flatulence.
sixtyniner	sixtyniner.
Shawtypimp	Shawtypimp.
shawtypimp	shawtypimp.
asspuppies	asspuppies.
samckdaddy	samckdaddy.
children's	children's.
sniggering	sniggering.
Flatulence	Flatulence.
Lovepistol	Lovepistol.
Palesimian	Palesimian.
pussyeater	pussyeater.
Headlights	Headlights.
Bigbastard	Bigbastard.
sleezeball	sleezeball.
Fingerfuck	Fingerfuck.
greaseball	greaseball.
lovemuscle	lovemuscle.
suckmydick	suckmydick.
Mickeyfinn	Mickeyfinn.
republican	republican.
dicklicker	dicklicker.
Sonofbitch	Sonofbitch.
Balllicker	Balllicker.
Propaganda	Propaganda.
Beastality	Beastality.
whiskydick	whiskydick.
cocksmoker	cocksmoker.
gangbanged	gangbanged.
Gangbanged	Gangbanged.
fourtwenty	fourtwenty.
Bestiality	Bestiality.
transexual	transexual.
propaganda	propaganda.
facefucker	facefucker.
Fistfucker	Fistfucker.
Dicklicker	Dicklicker.
kunilingus	kunilingus.
Cuntfucker	Cuntfucker.
Cocklicker	Cocklicker.
pussylover	pussylover.
Shitfucker	Shitfucker.
cocklicker	cocklicker.
Suckmydick	Suckmydick.
peckerwood	peckerwood.
Niggaracci	Niggaracci.
Gangbanger	Gangbanger.
mothafucka	mothafucka.
Pussylover	Pussylover.
beastality	beastality.
footaction	footaction.
Homosexual	Homosexual.
Peckerwood	Peckerwood.
snownigger	snownigger.
nipplering	nipplering.
Nastybitch	Nastybitch.
Australian	Australian.
gonorrehea	gonorrehea.
pocketpool	pocketpool.
Sixtyniner	Sixtyniner.
cocksucker	cocksucker.
Whitetrash	Whitetrash.
Footfucker	Footfucker.
Facefucker	Facefucker.
Sleezeball	Sleezeball.
Cuntsucker	Cuntsucker.
loverocket	loverocket.
crackwhore	crackwhore.
Stupidfuck	Stupidfuck.
Cuntlicker	Cuntlicker.
stupidfuck	stupidfuck.
Gonorrehea	Gonorrehea.
Spermacide	Spermacide.
cunilingus	cunilingus.
Unfuckable	Unfuckable.
prostitute	prostitute.
gangbanger	gangbanger.
niggaracci	niggaracci.
Fistfucked	Fistfucked.
nastywhore	nastywhore.
Children's	Children's.
skankbitch	skankbitch.
conspiracy	conspiracy.
corruption	corruption.
Deapthroat	Deapthroat.
sonofbitch	sonofbitch.
Fuckinnuts	Fuckinnuts.
Skankbitch	Skankbitch.
motherfuck	motherfuck.
cuntlicker	cuntlicker.
buttfucker	buttfucker.
Crackwhore	Crackwhore.
clamdigger	clamdigger.
shithapens	shithapens.
Greaseball	Greaseball.
australian	australian.
zipperhead	zipperhead.
cockcowboy	cockcowboy.
piccaninny	piccaninny.
balllicker	balllicker.
mickeyfinn	mickeyfinn.
Assblaster	Assblaster.
bigbastard	bigbastard.
homosexual	homosexual.
Niggerhole	Niggerhole.
Corruption	Corruption.
cuntsucker	cuntsucker.
Chickslick	Chickslick.
Fuckmonkey	Fuckmonkey.
fuckfriend	fuckfriend.
Pussyeater	Pussyeater.
Protestant	Protestant.
Prostitute	Prostitute.
Whorehouse	Whorehouse.
Cocksucked	Cocksucked.
whitetrash	whitetrash.
mastabater	mastabater.
Cunilingus	Cunilingus.
niggerhole	niggerhole.
cocksucked	cocksucked.
Masturbate	Masturbate.
niggerhead	niggerhead.
headlights	headlights.
Buttpirate	Buttpirate.
Republican	Republican.
Kunilingus	Kunilingus.
lovepistol	lovepistol.
Nipplering	Nipplering.
Conspiracy	Conspiracy.
Piccaninny	Piccaninny.
spermacide	spermacide.
Niggerhead	Niggerhead.
Zipperhead	Zipperhead.
Shithapens	Shithapens.
Sniggering	Sniggering.
Fuckfriend	Fuckfriend.
Skankwhore	Skankwhore.
Clamdigger	Clamdigger.
Buttfucker	Buttfucker.
Mastabater	Mastabater.
buttpirate	buttpirate.
fuckmonkey	fuckmonkey.
chickslick	chickslick.
niggarding	niggarding.
fistfucker	fistfucker.
unfuckable	unfuckable.
Cocksucker	Cocksucker.
Assmuncher	Assmuncher.
Bumblefuck	Bumblefuck.
Fingerfood	Fingerfood.
Cockcowboy	Cockcowboy.
shitfucker	shitfucker.
ejaculated	ejaculated.
Ejaculated	Ejaculated.
butchbabes	butchbabes.
skankwhore	skankwhore.
Nastywhore	Nastywhore.
Asspuppies	Asspuppies.
Pickaninny	Pickaninny.
Samckdaddy	Samckdaddy.
whorehouse	whorehouse.
Footlicker	Footlicker.
Whiskydick	Whiskydick.
palesimian	palesimian.
shortfuck	shortfuck.
cocksmith	cocksmith.
Assfucker	Assfucker.
marijuana	marijuana.
butchdike	butchdike.
Asslicker	Asslicker.
pornflick	pornflick.
cockblock	cockblock.
Titfucker	Titfucker.
cumbubble	cumbubble.
Slaughter	Slaughter.
picaninny	picaninny.
Sniggered	Sniggered.
Rearentry	Rearentry.
Breastjob	Breastjob.
fuckfreak	fuckfreak.
fatfucker	fatfucker.
titfuckin	titfuckin.
disturbed	disturbed.
Asscowboy	Asscowboy.
cumjockey	cumjockey.
ethiopian	ethiopian.
Marijuana	Marijuana.
Nigerians	Nigerians.
assbagger	assbagger.
fornicate	fornicate.
upthebutt	upthebutt.
magicwand	magicwand.
Feltching	Feltching.
Shitfaced	Shitfaced.
Loadedgun	Loadedgun.
Penthouse	Penthouse.
Sexy-slim	Sexy-slim.
Analannie	Analannie.
slideitin	slideitin.
snigger's	snigger's.
Suckmytit	Suckmytit.
Buttmunch	Buttmunch.
Trisexual	Trisexual.
explosion	explosion.
Assranger	Assranger.
sweetness	sweetness.
Cocklover	Cocklover.
Goddamnit	Goddamnit.
Stripclub	Stripclub.
Magicwand	Magicwand.
pimpjuice	pimpjuice.
Crackpipe	Crackpipe.
buttstain	buttstain.
Titlicker	Titlicker.
Horseshit	Horseshit.
bountybar	bountybar.
pussylips	pussylips.
swallower	swallower.
lovejuice	lovejuice.
Suckmyass	Suckmyass.
Shithouse	Shithouse.
Freakfuck	Freakfuck.
Primetime	Primetime.
sniggered	sniggered.
Ethiopian	Ethiopian.
asscowboy	asscowboy.
Buttstain	Buttstain.
execution	execution.
rearentry	rearentry.
Asskisser	Asskisser.
Ejaculate	Ejaculate.
Dixiedyke	Dixiedyke.
stripclub	stripclub.
ejaculate	ejaculate.
goddammit	goddammit.
Slutwhore	Slutwhore.
hitlerist	hitlerist.
Catholics	Catholics.
Moneyshot	Moneyshot.
asskisser	asskisser.
skinflute	skinflute.
testicles	testicles.
slimeball	slimeball.
Bootycall	Bootycall.
dumbbitch	dumbbitch.
nigerians	nigerians.
fuckbuddy	fuckbuddy.
Cumjockey	Cumjockey.
Sweetness	Sweetness.
cockqueen	cockqueen.
Cocktease	Cocktease.
skankfuck	skankfuck.
pubiclice	pubiclice.
Mastabate	Mastabate.
asslicker	asslicker.
prickhead	prickhead.
Cockrider	Cockrider.
mastabate	mastabate.
Cigarette	Cigarette.
clamdiver	clamdiver.
Kumbullbe	Kumbullbe.
gatorbait	gatorbait.
Nastyslut	Nastyslut.
Threesome	Threesome.
niggardly	niggardly.
Swallower	Swallower.
niggarded	niggarded.
criminals	criminals.
penthouse	penthouse.
cocklover	cocklover.
Sleezebag	Sleezebag.
yellowman	yellowman.
Clamdiver	Clamdiver.
dixiedike	dixiedike.
slaughter	slaughter.
niggard's	niggard's.
towelhead	towelhead.
Fuckbuddy	Fuckbuddy.
primetime	primetime.
feltching	feltching.
goddamned	goddamned.
bitchslap	bitchslap.
nigglings	nigglings.
slutwhore	slutwhore.
Fornicate	Fornicate.
sexkitten	sexkitten.
Premature	Premature.
titlicker	titlicker.
Dumbbitch	Dumbbitch.
bi-sexual	bi-sexual.
assmonkey	assmonkey.
Communist	Communist.
butt-fuck	butt-fuck.
Christian	Christian.
Muffdiver	Muffdiver.
Mothafuck	Mothafuck.
Fuckfreak	Fuckfreak.
goddamnit	goddamnit.
sixsixsix	sixsixsix.
goddamnes	goddamnes.
dickbrain	dickbrain.
Testicles	Testicles.
Butt-bang	Butt-bang.
kumbullbe	kumbullbe.
shitfaced	shitfaced.
Hitlerism	Hitlerism.
Disturbed	Disturbed.
damnation	damnation.
Execution	Execution.
butchdyke	butchdyke.
Niggardly	Niggardly.
Terrorist	Terrorist.
suckmytit	suckmytit.
Fatfucker	Fatfucker.
Dragqueen	Dragqueen.
asspacker	asspacker.
Butchdyke	Butchdyke.
Dixiedike	Dixiedike.
Dragqween	Dragqween.
Towelhead	Towelhead.
butt-bang	butt-bang.
Assmonkey	Assmonkey.
Bicurious	Bicurious.
assfucker	assfucker.
Splittail	Splittail.
shitstain	shitstain.
slopehead	slopehead.
Explosion	Explosion.
Asspacker	Asspacker.
buttmunch	buttmunch.
cocktease	cocktease.
Kumbubble	Kumbubble.
threesome	threesome.
freakfuck	freakfuck.
Upthebutt	Upthebutt.
sexy-slim	sexy-slim.
Crotchrot	Crotchrot.
Nigglings	Nigglings.
Sixtynine	Sixtynine.
asspirate	asspirate.
cockrider	cockrider.
Pornflick	Pornflick.
Criminals	Criminals.
premature	premature.
dragqween	dragqween.
Skinflute	Skinflute.
Yellowman	Yellowman.
Fuckwhore	Fuckwhore.
splittail	splittail.
Cockfight	Cockfight.
Skankfuck	Skankfuck.
rentafuck	rentafuck.
fuckwhore	fuckwhore.
Sexkitten	Sexkitten.
Pimpjuice	Pimpjuice.
nutfucker	nutfucker.
crotchrot	crotchrot.
Butchdike	Butchdike.
Cockqueen	Cockqueen.
hottotrot	hottotrot.
Hijacking	Hijacking.
Rentafuck	Rentafuck.
Titfuckin	Titfuckin.
analannie	analannie.
loadedgun	loadedgun.
cigarette	cigarette.
Hitlerist	Hitlerist.
scallywag	scallywag.
moneyshot	moneyshot.
shiteater	shiteater.
Bi-sexual	Bi-sexual.
dragqueen	dragqueen.
Cocksucer	Cocksucer.
Shitstain	Shitstain.
Hottotrot	Hottotrot.
excrement	excrement.
christian	christian.
breastjob	breastjob.
cockfight	cockfight.
Pubiclice	Pubiclice.
communist	communist.
Cockblock	Cockblock.
suckmyass	suckmyass.
hijacking	hijacking.
mothafuck	mothafuck.
titfucker	titfucker.
Pussylips	Pussylips.
Assbagger	Assbagger.
Damnation	Damnation.
sleezebag	sleezebag.
bicurious	bicurious.
Bountybar	Bountybar.
Excrement	Excrement.
horseshit	horseshit.
Butt-fuck	Butt-fuck.
Goddammit	Goddammit.
assranger	assranger.
catholics	catholics.
shithouse	shithouse.
kumbubble	kumbubble.
Cocksmith	Cocksmith.
Picaninny	Picaninny.
Prickhead	Prickhead.
Cumbubble	Cumbubble.
Shortfuck	Shortfuck.
Nutfucker	Nutfucker.
Goddamned	Goddamned.
Bitchslap	Bitchslap.
Goddamnes	Goddamnes.
hitlerism	hitlerism.
cocksucer	cocksucer.
thicklips	thicklips.
assjockey	assjockey.
sixtynine	sixtynine.
Inthebuff	Inthebuff.
breastman	breastman.
Lovejuice	Lovejuice.
Scallywag	Scallywag.
Asspirate	Asspirate.
Niggard's	Niggard's.
Slimeball	Slimeball.
trisexual	trisexual.
inthebuff	inthebuff.
bootycall	bootycall.
dixiedyke	dixiedyke.
Gatorbait	Gatorbait.
Dickbrain	Dickbrain.
Thicklips	Thicklips.
Sixsixsix	Sixsixsix.
Shiteater	Shiteater.
muffdiver	muffdiver.
Slideitin	Slideitin.
nastyslut	nastyslut.
Assjockey	Assjockey.
Snigger's	Snigger's.
Breastman	Breastman.
Slopehead	Slopehead.
crackpipe	crackpipe.
Niggarded	Niggarded.
terrorist	terrorist.
narcotic	narcotic.
Homicide	Homicide.
Roundeye	Roundeye.
Headfuck	Headfuck.
Threeway	Threeway.
hijacker	hijacker.
Sniggers	Sniggers.
cockknob	cockknob.
homicide	homicide.
lapdance	lapdance.
cocktail	cocktail.
diseases	diseases.
Buttplug	Buttplug.
Felching	Felching.
niggards	niggards.
Phonesex	Phonesex.
bullshit	bullshit.
testicle	testicle.
murderer	murderer.
ballsack	ballsack.
freefuck	freefuck.
Footfuck	Footfuck.
cunteyed	cunteyed.
Foursome	Foursome.
screwyou	screwyou.
Abortion	Abortion.
jackshit	jackshit.
muffdive	muffdive.
buttface	buttface.
Fuckface	Fuckface.
vibrator	vibrator.
Copulate	Copulate.
niggling	niggling.
sexhound	sexhound.
Bullcrap	Bullcrap.
jizjuice	jizjuice.
snowback	snowback.
lovebone	lovebone.
Filipino	Filipino.
backseat	backseat.
bisexual	bisexual.
coloured	coloured.
Eatpussy	Eatpussy.
Butthead	Butthead.
fuckedup	fuckedup.
Horniest	Horniest.
sniggers	sniggers.
Retarded	Retarded.
Shagging	Shagging.
executed	executed.
sodomize	sodomize.
cemetery	cemetery.
Criminal	Criminal.
Redlight	Redlight.
playgirl	playgirl.
Datnigga	Datnigga.
Testicle	Testicle.
Givehead	Givehead.
barfface	barfface.
Nigerian	Nigerian.
filipina	filipina.
sexhouse	sexhouse.
Defecate	Defecate.
Cockhead	Cockhead.
datnigga	datnigga.
Vietcong	Vietcong.
shitface	shitface.
roundeye	roundeye.
bunghole	bunghole.
chinamen	chinamen.
chinaman	chinaman.
Sodomise	Sodomise.
bullcrap	bullcrap.
fuckfest	fuckfest.
Peepshow	Peepshow.
manhater	manhater.
clitoris	clitoris.
Erection	Erection.
Filipina	Filipina.
Lapdance	Lapdance.
Jackshit	Jackshit.
Ballsack	Ballsack.
thirdeye	thirdeye.
Buttfuck	Buttfuck.
sexually	sexually.
Narcotic	Narcotic.
Thirdeye	Thirdeye.
dripdick	dripdick.
dickless	dickless.
Assholes	Assholes.
Barfface	Barfface.
Cocksuck	Cocksuck.
assmunch	assmunch.
Pussycat	Pussycat.
Uptheass	Uptheass.
Thirdleg	Thirdleg.
Knockers	Knockers.
Fuckable	Fuckable.
Slutwear	Slutwear.
Mosshead	Mosshead.
spermbag	spermbag.
Shitlist	Shitlist.
footfuck	footfuck.
fuckface	fuckface.
retarded	retarded.
Lovebone	Lovebone.
foreskin	foreskin.
Cunteyed	Cunteyed.
minority	minority.
blackout	blackout.
Nigger's	Nigger's.
Screwyou	Screwyou.
Sexhouse	Sexhouse.
Bullshit	Bullshit.
foursome	foursome.
stroking	stroking.
Tuckahoe	Tuckahoe.
sexwhore	sexwhore.
Spigotty	Spigotty.
buttbang	buttbang.
footstar	footstar.
syphilis	syphilis.
swastika	swastika.
Assassin	Assassin.
canadian	canadian.
gotohell	gotohell.
abortion	abortion.
Dickless	Dickless.
assklown	assklown.
Cumqueen	Cumqueen.
pimpjuic	pimpjuic.
Arsehole	Arsehole.
Sexhound	Sexhound.
goddamit	goddamit.
Bulldike	Bulldike.
cocksman	cocksman.
Fuckhead	Fuckhead.
Assclown	Assclown.
defecate	defecate.
Cockknob	Cockknob.
Stringer	Stringer.
Dicklick	Dicklick.
dicklick	dicklick.
Coloured	Coloured.
easyslut	easyslut.
Canadian	Canadian.
pornking	pornking.
buggered	buggered.
gonzagas	gonzagas.
felching	felching.
Suckdick	Suckdick.
Shitfull	Shitfull.
Bisexual	Bisexual.
blackman	blackman.
fellatio	fellatio.
Jizjuice	Jizjuice.
Dumbfuck	Dumbfuck.
Cemetery	Cemetery.
godammit	godammit.
mosshead	mosshead.
Cocktail	Cocktail.
fuckknob	fuckknob.
Spermbag	Spermbag.
Fucktard	Fucktard.
molestor	molestor.
shitdick	shitdick.
Dickweed	Dickweed.
Manpaste	Manpaste.
Sodomite	Sodomite.
beastial	beastial.
Executed	Executed.
Vibrator	Vibrator.
vibrater	vibrater.
cockhead	cockhead.
knockers	knockers.
nigerian	nigerian.
Muffdive	Muffdive.
molester	molester.
Asswhore	Asswhore.
hotpussy	hotpussy.
Radicals	Radicals.
Italiano	Italiano.
Fuckfest	Fuckfest.
shitlist	shitlist.
vietcong	vietcong.
phukking	phukking.
Fuckedup	Fuckedup.
european	european.
Sodomize	Sodomize.
Buggered	Buggered.
Chinaman	Chinaman.
nigger's	nigger's.
Gotohell	Gotohell.
Diseases	Diseases.
Easyslut	Easyslut.
Slanteye	Slanteye.
slanteye	slanteye.
shagging	shagging.
lingerie	lingerie.
Jijjiboo	Jijjiboo.
Sexwhore	Sexwhore.
violence	violence.
Shitting	Shitting.
bulldike	bulldike.
Minority	Minority.
Blackout	Blackout.
shitfuck	shitfuck.
pimpsimp	pimpsimp.
Lingerie	Lingerie.
Assmunch	Assmunch.
Dipstick	Dipstick.
Dickhead	Dickhead.
Feltcher	Feltcher.
Bulldyke	Bulldyke.
threeway	threeway.
Sexymoma	Sexymoma.
Godammit	Godammit.
Fuckknob	Fuckknob.
erection	erection.
pussycat	pussycat.
Swastika	Swastika.
slutwear	slutwear.
Titlover	Titlover.
cuntlick	cuntlick.
shitfull	shitfull.
Foreskin	Foreskin.
cybersex	cybersex.
Clitoris	Clitoris.
Limpdick	Limpdick.
Phukking	Phukking.
cornhole	cornhole.
Gangbang	Gangbang.
meatrack	meatrack.
Japanese	Japanese.
Fistfuck	Fistfuck.
Buttbang	Buttbang.
buttfuck	buttfuck.
Violence	Violence.
Murderer	Murderer.
Bunghole	Bunghole.
fucktard	fucktard.
European	European.
cuntfuck	cuntfuck.
Shooting	Shooting.
beat-off	beat-off.
givehead	givehead.
japanese	japanese.
Asslover	Asslover.
Shithead	Shithead.
Cornhole	Cornhole.
Assklown	Assklown.
ontherag	ontherag.
showtime	showtime.
tuckahoe	tuckahoe.
israel's	israel's.
spigotty	spigotty.
suckdick	suckdick.
fuckhead	fuckhead.
Sexually	Sexually.
criminal	criminal.
headfuck	headfuck.
Shitface	Shitface.
Shitdick	Shitdick.
Ontherag	Ontherag.
Niggards	Niggards.
Beat-off	Beat-off.
intheass	intheass.
sodomite	sodomite.
sodomise	sodomise.
sexymoma	sexymoma.
Footstar	Footstar.
Intheass	Intheass.
Beastial	Beastial.
butthead	butthead.
Pimpsimp	Pimpsimp.
phonesex	phonesex.
Hijacker	Hijacker.
Fastfuck	Fastfuck.
Showtime	Showtime.
asslover	asslover.
Pimpjuic	Pimpjuic.
Goddamit	Goddamit.
Pisshead	Pisshead.
shithead	shithead.
jijjiboo	jijjiboo.
Pornking	Pornking.
Chinamen	Chinamen.
dumbfuck	dumbfuck.
uptheass	uptheass.
gangbang	gangbang.
Manhater	Manhater.
filipino	filipino.
Henhouse	Henhouse.
Gonzagas	Gonzagas.
american	american.
titlover	titlover.
Bitching	Bitching.
Molester	Molester.
eatballs	eatballs.
eatpussy	eatpussy.
dipstick	dipstick.
Playgirl	Playgirl.
Sexslave	Sexslave.
shooting	shooting.
Vibrater	Vibrater.
Dripdick	Dripdick.
radicals	radicals.
Cuntfuck	Cuntfuck.
asswhore	asswhore.
poontang	poontang.
cumqueen	cumqueen.
Snowback	Snowback.
assclown	assclown.
Slutting	Slutting.
pisshead	pisshead.
Cocksman	Cocksman.
Fellatio	Fellatio.
bazongas	bazongas.
Cameltoe	Cameltoe.
Hotpussy	Hotpussy.
American	American.
assassin	assassin.
Bazongas	Bazongas.
cocksuck	cocksuck.
henhouse	henhouse.
sexslave	sexslave.
backdoor	backdoor.
Backseat	Backseat.
bulldyke	bulldyke.
Catholic	Catholic.
Shitfuck	Shitfuck.
Blackman	Blackman.
Backdoor	Backdoor.
assholes	assholes.
thirdleg	thirdleg.
Syphilis	Syphilis.
Poontang	Poontang.
buttplug	buttplug.
manpaste	manpaste.
cameltoe	cameltoe.
Niggling	Niggling.
slutting	slutting.
arsehole	arsehole.
bitching	bitching.
stringer	stringer.
dickweed	dickweed.
peepshow	peepshow.
redlight	redlight.
limpdick	limpdick.
Buttface	Buttface.
Peepshpw	Peepshpw.
fuckable	fuckable.
Cuntlick	Cuntlick.
fastfuck	fastfuck.
feltcher	feltcher.
Molestor	Molestor.
copulate	copulate.
Eatballs	Eatballs.
fistfuck	fistfuck.
Stroking	Stroking.
Freefuck	Freefuck.
Israel's	Israel's.
peepshpw	peepshpw.
italiano	italiano.
Meatrack	Meatrack.
Cybersex	Cybersex.
horniest	horniest.
shitting	shitting.
catholic	catholic.
dickhead	dickhead.
poverty	poverty.
cumshot	cumshot.
colored	colored.
bitchez	bitchez.
Lesbain	Lesbain.
Reestie	Reestie.
lesbian	lesbian.
drunken	drunken.
pooping	pooping.
Bombing	Bombing.
hotdamn	hotdamn.
negro's	negro's.
Lucifer	Lucifer.
Bastard	Bastard.
Lovegoo	Lovegoo.
Suicide	Suicide.
dumbass	dumbass.
fagging	fagging.
jiggabo	jiggabo.
sexfarm	sexfarm.
Mulatto	Mulatto.
niggard	niggard.
Peehole	Peehole.
Genital	Genital.
Shitter	Shitter.
Bitcher	Bitcher.
Funfuck	Funfuck.
lucifer	lucifer.
japcrap	japcrap.
Pissing	Pissing.
liberal	liberal.
Urinary	Urinary.
juggalo	juggalo.
welfare	welfare.
Liberal	Liberal.
Torture	Torture.
Whigger	Whigger.
Pindick	Pindick.
Quashie	Quashie.
quashie	quashie.
Phuking	Phuking.
asshole	asshole.
Quickie	Quickie.
bastard	bastard.
Felatio	Felatio.
Wetback	Wetback.
snigger	snigger.
Sheeney	Sheeney.
urinary	urinary.
Hotdamn	Hotdamn.
Felcher	Felcher.
Dipshit	Dipshit.
negroes	negroes.
titfuck	titfuck.
whigger	whigger.
Bollock	Bollock.
Servant	Servant.
Fuckers	Fuckers.
Amateur	Amateur.
Swallow	Swallow.
Jerkoff	Jerkoff.
Welcher	Welcher.
Cumming	Cumming.
Pissoff	Pissoff.
killing	killing.
pussies	pussies.
fuckbag	fuckbag.
servant	servant.
Fairies	Fairies.
assault	assault.
Pansies	Pansies.
pissing	pissing.
Bumfuck	Bumfuck.
Assault	Assault.
niggers	niggers.
Dickman	Dickman.
Puddboy	Puddboy.
baptist	baptist.
Cumquat	Cumquat.
lesbayn	lesbayn.
Buggery	Buggery.
jackass	jackass.
Analsex	Analsex.
Panties	Panties.
Twinkie	Twinkie.
urinate	urinate.
Radical	Radical.
Rimming	Rimming.
skumbag	skumbag.
Disease	Disease.
negroid	negroid.
Bondage	Bondage.
bumfuck	bumfuck.
Vaginal	Vaginal.
carruth	carruth.
analsex	analsex.
Shitcan	Shitcan.
mulatto	mulatto.
swallow	swallow.
rearend	rearend.
Shitola	Shitola.
Goddamn	Goddamn.
remains	remains.
Refugee	Refugee.
Lactate	Lactate.
Kumming	Kumming.
Jigaboo	Jigaboo.
lovegun	lovegun.
rimming	rimming.
Colored	Colored.
Shiting	Shiting.
Crapper	Crapper.
dickwad	dickwad.
niggles	niggles.
Redneck	Redneck.
goddamn	goddamn.
asshore	asshore.
tarbaby	tarbaby.
buggery	buggery.
whacker	whacker.
Bitchez	Bitchez.
Triplex	Triplex.
Fuckbag	Fuckbag.
strapon	strapon.
niggled	niggled.
amateur	amateur.
shitted	shitted.
gangsta	gangsta.
Baptist	Baptist.
muncher	muncher.
Fuckina	Fuckina.
Shaggin	Shaggin.
triplex	triplex.
Jiggabo	Jiggabo.
honkers	honkers.
cocaine	cocaine.
Beatoff	Beatoff.
Russkie	Russkie.
dipshit	dipshit.
Asslick	Asslick.
badfuck	badfuck.
Farting	Farting.
mexican	mexican.
Coondog	Coondog.
genital	genital.
torture	torture.
Fisting	Fisting.
russkie	russkie.
disease	disease.
suicide	suicide.
bollick	bollick.
lesbain	lesbain.
Fuckyou	Fuckyou.
Wetspot	Wetspot.
shitfit	shitfit.
Clogwog	Clogwog.
bitchin	bitchin.
Trannie	Trannie.
boobies	boobies.
Mexican	Mexican.
kumming	kumming.
puddboy	puddboy.
kumquat	kumquat.
barface	barface.
Juggalo	Juggalo.
israeli	israeli.
Barface	Barface.
Nastyho	Nastyho.
Penises	Penises.
reestie	reestie.
phukked	phukked.
Spitter	Spitter.
pansies	pansies.
Cocaine	Cocaine.
Illegal	Illegal.
Vatican	Vatican.
Honkers	Honkers.
Execute	Execute.
asswipe	asswipe.
slapper	slapper.
Suckoff	Suckoff.
clogwog	clogwog.
Asshore	Asshore.
fuckers	fuckers.
Shinola	Shinola.
Hooters	Hooters.
Negroes	Negroes.
quickie	quickie.
Sextoys	Sextoys.
Fagging	Fagging.
penises	penises.
Urinate	Urinate.
lowlife	lowlife.
Israeli	Israeli.
Cumshot	Cumshot.
Strapon	Strapon.
welcher	welcher.
Niggles	Niggles.
kissass	kissass.
Drunken	Drunken.
shiting	shiting.
Lovegun	Lovegun.
Lubejob	Lubejob.
Titties	Titties.
Fuckoff	Fuckoff.
titties	titties.
Gangsta	Gangsta.
wanking	wanking.
phuking	phuking.
bondage	bondage.
bigbutt	bigbutt.
fuckyou	fuckyou.
Lesbian	Lesbian.
shinola	shinola.
bitcher	bitcher.
handjob	handjob.
doo-doo	doo-doo.
funeral	funeral.
Orgasim	Orgasim.
Fatfuck	Fatfuck.
sextogo	sextogo.
Snigger	Snigger.
Blowjob	Blowjob.
Wanking	Wanking.
pindick	pindick.
Kumquat	Kumquat.
Hiscock	Hiscock.
Welfare	Welfare.
Bitchin	Bitchin.
Funeral	Funeral.
Brothel	Brothel.
brothel	brothel.
Carruth	Carruth.
bollock	bollock.
Addicts	Addicts.
Jackoff	Jackoff.
orgasim	orgasim.
Tarbaby	Tarbaby.
assfuck	assfuck.
jigaboo	jigaboo.
hosejob	hosejob.
Niggard	Niggard.
Buttman	Buttman.
Rearend	Rearend.
Hosejob	Hosejob.
playboy	playboy.
mideast	mideast.
puntang	puntang.
phungky	phungky.
Deposit	Deposit.
Skumbag	Skumbag.
bitches	bitches.
Schlong	Schlong.
Bestial	Bestial.
Hookers	Hookers.
Remains	Remains.
shaggin	shaggin.
spitter	spitter.
livesex	livesex.
Muncher	Muncher.
Livesex	Livesex.
Whiskey	Whiskey.
scrotum	scrotum.
jimfish	jimfish.
Aroused	Aroused.
Jimfish	Jimfish.
asslick	asslick.
Lesbayn	Lesbayn.
Ecstacy	Ecstacy.
Pussies	Pussies.
Pooping	Pooping.
ecstacy	ecstacy.
Lowlife	Lowlife.
trannie	trannie.
women's	women's.
Jackass	Jackass.
Pee-pee	Pee-pee.
vatican	vatican.
Slapper	Slapper.
asskiss	asskiss.
Niggers	Niggers.
Asshole	Asshole.
Fuckher	Fuckher.
Puntang	Puntang.
fairies	fairies.
cumming	cumming.
addicts	addicts.
cumquat	cumquat.
Kissass	Kissass.
whiskey	whiskey.
jackoff	jackoff.
Hostage	Hostage.
illegal	illegal.
fucking	fucking.
hostage	hostage.
shitter	shitter.
cumfest	cumfest.
Whacker	Whacker.
crapper	crapper.
Boobies	Boobies.
sheeney	sheeney.
pissoff	pissoff.
schlong	schlong.
bombing	bombing.
fuckina	fuckina.
chinese	chinese.
Cumfest	Cumfest.
fuckoff	fuckoff.
getiton	getiton.
Niggled	Niggled.
waysted	waysted.
Mideast	Mideast.
hooters	hooters.
lovegoo	lovegoo.
bestial	bestial.
Banging	Banging.
Phukked	Phukked.
Cocknob	Cocknob.
Dumbass	Dumbass.
bombers	bombers.
Handjob	Handjob.
Women's	Women's.
Raghead	Raghead.
hustler	hustler.
Waysted	Waysted.
bazooms	bazooms.
dickman	dickman.
Titfuck	Titfuck.
Badfuck	Badfuck.
sextoys	sextoys.
raghead	raghead.
Bazooms	Bazooms.
Bollick	Bollick.
Playboy	Playboy.
wetspot	wetspot.
vaginal	vaginal.
twinkie	twinkie.
Sexfarm	Sexfarm.
Shitfit	Shitfit.
coondog	coondog.
Phungky	Phungky.
African	African.
hookers	hookers.
blowjob	blowjob.
Negro's	Negro's.
felatio	felatio.
nastyho	nastyho.
deposit	deposit.
Bombers	Bombers.
panties	panties.
fatfuck	fatfuck.
felcher	felcher.
aroused	aroused.
Asskiss	Asskiss.
Shitted	Shitted.
Negroid	Negroid.
Chinese	Chinese.
redneck	redneck.
Scrotum	Scrotum.
fuckher	fuckher.
Bitches	Bitches.
Getiton	Getiton.
funfuck	funfuck.
upskirt	upskirt.
jerkoff	jerkoff.
Destroy	Destroy.
Fucking	Fucking.
shitola	shitola.
fisting	fisting.
Killing	Killing.
refugee	refugee.
lactate	lactate.
beatoff	beatoff.
shitcan	shitcan.
Poverty	Poverty.
failure	failure.
Bigbutt	Bigbutt.
lubejob	lubejob.
Fuckpig	Fuckpig.
suckoff	suckoff.
pee-pee	pee-pee.
execute	execute.
wetback	wetback.
african	african.
Asswipe	Asswipe.
Hustler	Hustler.
farting	farting.
radical	radical.
peehole	peehole.
destroy	destroy.
cocknob	cocknob.
flasher	flasher.
Japcrap	Japcrap.
buttman	buttman.
Failure	Failure.
Dickwad	Dickwad.
crapola	crapola.
hiscock	hiscock.
banging	banging.
Doo-doo	Doo-doo.
Crapola	Crapola.
Assfuck	Assfuck.
Flasher	Flasher.
Sextogo	Sextogo.
fuckpig	fuckpig.
Upskirt	Upskirt.
Areola	Areola.
Racial	Racial.
escort	escort.
pistol	pistol.
Tortur	Tortur.
nookie	nookie.
Gyppie	Gyppie.
krappy	krappy.
Babies	Babies.
robber	robber.
Africa	Africa.
Nooner	Nooner.
Incest	Incest.
nudger	nudger.
fuckit	fuckit.
chinky	chinky.
Failed	Failed.
Tittie	Tittie.
Slopey	Slopey.
Kanake	Kanake.
Iblowu	Iblowu.
Gringo	Gringo.
pommie	pommie.
Pooper	Pooper.
Hummer	Hummer.
Tantra	Tantra.
moslem	moslem.
firing	firing.
shited	shited.
retard	retard.
kondum	kondum.
Noonan	Noonan.
dammit	dammit.
Toilet	Toilet.
mockie	mockie.
rectum	rectum.
weapon	weapon.
Zigabo	Zigabo.
pisser	pisser.
pecker	pecker.
Tosser	Tosser.
feltch	feltch.
Escort	Escort.
niggor	niggor.
Nudger	Nudger.
sniper	sniper.
Darkie	Darkie.
kigger	kigger.
period	period.
Kigger	Kigger.
gringo	gringo.
killed	killed.
nittit	nittit.
Swalow	Swalow.
Wanker	Wanker.
tortur	tortur.
darkie	darkie.
Weenie	Weenie.
Farted	Farted.
Fister	Fister.
soviet	soviet.
spunky	spunky.
hitler	hitler.
suckme	suckme.
dahmer	dahmer.
Sucker	Sucker.
Rapist	Rapist.
turnon	turnon.
Hijack	Hijack.
gummer	gummer.
bigger	bigger.
hooker	hooker.
Pudboy	Pudboy.
skanky	skanky.
Jizzum	Jizzum.
Dahmer	Dahmer.
stiffy	stiffy.
Mormon	Mormon.
crappy	crappy.
Pimped	Pimped.
Wigger	Wigger.
horney	horney.
Tampon	Tampon.
flydye	flydye.
reefer	reefer.
Orgasm	Orgasm.
Turnon	Turnon.
Slutty	Slutty.
diddle	diddle.
Feltch	Feltch.
willie	willie.
creamy	creamy.
liquor	liquor.
Israel	Israel.
whitey	whitey.
honger	honger.
Titjob	Titjob.
niggur	niggur.
Rectum	Rectum.
Nignog	Nignog.
Attack	Attack.
faggot	faggot.
wanker	wanker.
Commie	Commie.
Stroke	Stroke.
Christ	Christ.
Period	Period.
Condom	Condom.
Liquor	Liquor.
Addict	Addict.
sexpot	sexpot.
Hodgie	Hodgie.
bugger	bugger.
Vagina	Vagina.
Reefer	Reefer.
slutty	slutty.
Creamy	Creamy.
popimp	popimp.
Looser	Looser.
coitus	coitus.
titjob	titjob.
Hooker	Hooker.
Chinky	Chinky.
breast	breast.
Sexpot	Sexpot.
Nookie	Nookie.
Phuked	Phuked.
insest	insest.
orgasm	orgasm.
Krappy	Krappy.
pisses	pisses.
Tranny	Tranny.
faeces	faeces.
yankee	yankee.
Molest	Molest.
farted	farted.
sucker	sucker.
beaver	beaver.
Racist	Racist.
Assman	Assman.
virgin	virgin.
Asshat	Asshat.
Geezer	Geezer.
tosser	tosser.
jigger	jigger.
kaffir	kaffir.
Orgies	Orgies.
Cacker	Cacker.
herpes	herpes.
iblowu	iblowu.
biatch	biatch.
Pissed	Pissed.
blacks	blacks.
Mockie	Mockie.
Lotion	Lotion.
pissed	pissed.
toilet	toilet.
Killed	Killed.
Hitler	Hitler.
Nigger	Nigger.
dyefly	dyefly.
polack	polack.
reject	reject.
Kaffre	Kaffre.
looser	looser.
Niggle	Niggle.
hummer	hummer.
sextoy	sextoy.
Tinkle	Tinkle.
fckcum	fckcum.
Dyefly	Dyefly.
Fuckin	Fuckin.
Licker	Licker.
Gaysex	Gaysex.
Fondle	Fondle.
cacker	cacker.
Uterus	Uterus.
racist	racist.
killer	killer.
Damnit	Damnit.
Sexual	Sexual.
weenie	weenie.
pimped	pimped.
Fungus	Fungus.
Fuckme	Fuckme.
noonan	noonan.
German	German.
Nookey	Nookey.
terror	terror.
kanake	kanake.
Fucked	Fucked.
fuckin	fuckin.
Niggur	Niggur.
tinkle	tinkle.
Sniper	Sniper.
nooner	nooner.
honkey	honkey.
Ethnic	Ethnic.
Pisses	Pisses.
Diddle	Diddle.
molest	molest.
byatch	byatch.
nipple	nipple.
sexing	sexing.
Bugger	Bugger.
Reject	Reject.
fucked	fucked.
Weewee	Weewee.
Coitus	Coitus.
Fetish	Fetish.
lotion	lotion.
fatass	fatass.
Flange	Flange.
tittie	tittie.
Pissin	Pissin.
Robber	Robber.
doodoo	doodoo.
Willie	Willie.
babies	babies.
pimper	pimper.
stupid	stupid.
jizzim	jizzim.
licker	licker.
Pistol	Pistol.
Pisser	Pisser.
commie	commie.
attack	attack.
hindoo	hindoo.
Ribbed	Ribbed.
Gummer	Gummer.
Rimjob	Rimjob.
Hardon	Hardon.
Polack	Polack.
Boonie	Boonie.
Retard	Retard.
Stiffy	Stiffy.
sodomy	sodomy.
flange	flange.
Niggah	Niggah.
lesbin	lesbin.
Niglet	Niglet.
zigabo	zigabo.
Fatass	Fatass.
biteme	biteme.
Libido	Libido.
Macaca	Macaca.
nlggor	nlggor.
Boonga	Boonga.
hardon	hardon.
gaysex	gaysex.
addict	addict.
muslim	muslim.
Niggaz	Niggaz.
Lolita	Lolita.
Cunntt	Cunntt.
cummer	cummer.
fuckme	fuckme.
coolie	coolie.
Murder	Murder.
hijack	hijack.
Weapon	Weapon.
kummer	kummer.
Heroin	Heroin.
desire	desire.
Nlgger	Nlgger.
Crappy	Crappy.
Spooge	Spooge.
rapist	rapist.
Virgin	Virgin.
areola	areola.
libido	libido.
Desire	Desire.
Spunky	Spunky.
Bitchy	Bitchy.
fucker	fucker.
kaffre	kaffre.
Snatch	Snatch.
swalow	swalow.
Nlggor	Nlggor.
kaffer	kaffer.
Suckme	Suckme.
tantra	tantra.
Faggot	Faggot.
tampon	tampon.
wigger	wigger.
Beaner	Beaner.
Bigass	Bigass.
Harder	Harder.
Honkey	Honkey.
russki	russki.
Pecker	Pecker.
condom	condom.
christ	christ.
Beaver	Beaver.
Crotch	Crotch.
Pimper	Pimper.
Biatch	Biatch.
pussie	pussie.
Breast	Breast.
boonga	boonga.
Cancer	Cancer.
Pussie	Pussie.
Mockey	Mockey.
Killer	Killer.
Jigger	Jigger.
lickme	lickme.
Whites	Whites.
german	german.
Horney	Horney.
israel	israel.
Muslim	Muslim.
ethnic	ethnic.
Hindoo	Hindoo.
Fucker	Fucker.
snatch	snatch.
racial	racial.
buried	buried.
brea5t	brea5t.
Doodoo	Doodoo.
Niggor	Niggor.
mormon	mormon.
Faeces	Faeces.
tranny	tranny.
Lesbin	Lesbin.
bohunk	bohunk.
Yankee	Yankee.
Wuzzie	Wuzzie.
vagina	vagina.
Shited	Shited.
nignog	nignog.
Fckcum	Fckcum.
lolita	lolita.
nigger	nigger.
niglet	niglet.
Insest	Insest.
Cummer	Cummer.
church	church.
Flydye	Flydye.
asshat	asshat.
Trojan	Trojan.
Sexing	Sexing.
crimes	crimes.
Russki	Russki.
mockey	mockey.
crotch	crotch.
Blacks	Blacks.
Herpes	Herpes.
Honger	Honger.
Fuckit	Fuckit.
hodgie	hodgie.
Sodomy	Sodomy.
Nittit	Nittit.
heroin	heroin.
Church	Church.
Buried	Buried.
Shitty	Shitty.
fungus	fungus.
wuzzie	wuzzie.
rigger	rigger.
Coolie	Coolie.
damnit	damnit.
Kaffir	Kaffir.
orgies	orgies.
Penile	Penile.
rimjob	rimjob.
trojan	trojan.
penile	penile.
Kaffer	Kaffer.
shitty	shitty.
Whitey	Whitey.
fister	fister.
Popimp	Popimp.
Stupid	Stupid.
phuked	phuked.
jizzum	jizzum.
niggle	niggle.
sexual	sexual.
macaca	macaca.
Firing	Firing.
beaner	beaner.
jewish	jewish.
Sextoy	Sextoy.
ribbed	ribbed.
geezer	geezer.
tongue	tongue.
murder	murder.
boonie	boonie.
Lickme	Lickme.
Tongue	Tongue.
Kummer	Kummer.
Jewish	Jewish.
Flydie	Flydie.
nookey	nookey.
niggah	niggah.
incest	incest.
whites	whites.
Nipple	Nipple.
africa	africa.
Moslem	Moslem.
Kondum	Kondum.
Terror	Terror.
bigass	bigass.
weewee	weewee.
Soviet	Soviet.
niggaz	niggaz.
failed	failed.
Pommie	Pommie.
Crimes	Crimes.
nlgger	nlgger.
Biteme	Biteme.
fetish	fetish.
Bigger	Bigger.
uterus	uterus.
slopey	slopey.
Dammit	Dammit.
Rigger	Rigger.
cancer	cancer.
Skanky	Skanky.
Brea5t	Brea5t.
Byatch	Byatch.
spooge	spooge.
pissin	pissin.
cunntt	cunntt.
pooper	pooper.
Bohunk	Bohunk.
assman	assman.
pudboy	pudboy.
gyppie	gyppie.
bitchy	bitchy.
Jizzim	Jizzim.
fondle	fondle.
harder	harder.
stroke	stroke.
flydie	flydie.
bogan	bogan.
booby	booby.
darky	darky.
Taboo	Taboo.
loser	loser.
Moron	Moron.
kills	kills.
Moles	Moles.
Devil	Devil.
hoser	hoser.
Pixie	Pixie.
faith	faith.
enemy	enemy.
Lynch	Lynch.
Roach	Roach.
Piker	Piker.
Forni	Forni.
bible	bible.
negro	negro.
balls	balls.
ginzo	ginzo.
Smack	Smack.
sooty	sooty.
Titty	Titty.
Porno	Porno.
Vulva	Vulva.
fatah	fatah.
urine	urine.
cooly	cooly.
Dildo	Dildo.
Teste	Teste.
Slave	Slave.
fucks	fucks.
Crabs	Crabs.
Rabbi	Rabbi.
fight	fight.
Loser	Loser.
Negro	Negro.
pixie	pixie.
Fraud	Fraud.
Boobs	Boobs.
Girls	Girls.
Boody	Boody.
Fubar	Fubar.
Chode	Chode.
Fight	Fight.
moron	moron.
fraud	fraud.
Pocho	Pocho.
lezbo	lezbo.
Honky	Honky.
gross	gross.
Idiot	Idiot.
boang	boang.
beast	beast.
sexed	sexed.
Sandm	Sandm.
choad	choad.
kotex	kotex.
shits	shits.
panti	panti.
Semen	Semen.
shite	shite.
screw	screw.
Death	Death.
Asian	Asian.
Pikey	Pikey.
sandm	sandm.
fucck	fucck.
Angie	Angie.
pu55y	pu55y.
crash	crash.
Whash	Whash.
trots	trots.
niger	niger.
black	black.
slopy	slopy.
fagot	fagot.
naked	naked.
Raped	Raped.
taboo	taboo.
bombs	bombs.
Gyppo	Gyppo.
feces	feces.
whash	whash.
Boang	Boang.
Color	Color.
usama	usama.
Latin	Latin.
Ginzo	Ginzo.
Hymie	Hymie.
mgger	mgger.
Harem	Harem.
Kafir	Kafir.
Whore	Whore.
Kraut	Kraut.
shhit	shhit.
lezzo	lezzo.
Drunk	Drunk.
Naked	Naked.
fugly	fugly.
enema	enema.
Hamas	Hamas.
Slant	Slant.
abuse	abuse.
Spank	Spank.
goyim	goyim.
slutt	slutt.
Hoser	Hoser.
Spunk	Spunk.
cra5h	cra5h.
sissy	sissy.
hamas	hamas.
Lesbo	Lesbo.
lynch	lynch.
Sodom	Sodom.
Slutt	Slutt.
hussy	hussy.
Necro	Necro.
Nymph	Nymph.
Sperm	Sperm.
raped	raped.
Shits	Shits.
Cohee	Cohee.
Fugly	Fugly.
boody	boody.
Husky	Husky.
boobs	boobs.
Fuuck	Fuuck.
mggor	mggor.
Angry	Angry.
Fairy	Fairy.
Usama	Usama.
piker	piker.
Nigga	Nigga.
Goyim	Goyim.
chode	chode.
Raper	Raper.
Vomit	Vomit.
pocho	pocho.
Shite	Shite.
stagg	stagg.
Willy	Willy.
gubba	gubba.
Lugan	Lugan.
mafia	mafia.
slave	slave.
pansy	pansy.
Spick	Spick.
Cooly	Cooly.
dirty	dirty.
Pussy	Pussy.
semen	semen.
pendy	pendy.
Stagg	Stagg.
lezbe	lezbe.
Fucck	Fucck.
Pubic	Pubic.
queef	queef.
Lezbo	Lezbo.
Pendy	Pendy.
Felch	Felch.
Penis	Penis.
Eatme	Eatme.
Sadis	Sadis.
Horny	Horny.
husky	husky.
Enemy	Enemy.
spick	spick.
Sadom	Sadom.
girls	girls.
Crash	Crash.
harem	harem.
Arabs	Arabs.
fatso	fatso.
Screw	Screw.
Gyppy	Gyppy.
Lezbe	Lezbe.
jebus	jebus.
Jizim	Jizim.
Booty	Booty.
jiggy	jiggy.
Urine	Urine.
Fatso	Fatso.
jesus	jesus.
Boong	Boong.
Abuse	Abuse.
Fucka	Fucka.
jigga	jigga.
Farty	Farty.
Mocky	Mocky.
nigga	nigga.
willy	willy.
Queef	Queef.
osama	osama.
sodom	sodom.
horny	horny.
Seppo	Seppo.
arabs	arabs.
Kills	Kills.
tramp	tramp.
raper	raper.
Feces	Feces.
twink	twink.
pommy	pommy.
Nasty	Nasty.
spunk	spunk.
vulva	vulva.
spank	spank.
Queer	Queer.
Beast	Beast.
Randy	Randy.
squaw	squaw.
Choad	Choad.
boner	boner.
asian	asian.
hymie	hymie.
penis	penis.
Jigga	Jigga.
fucka	fucka.
Sissy	Sissy.
Allah	Allah.
bitch	bitch.
Fucks	Fucks.
Fatah	Fatah.
Tramp	Tramp.
color	color.
kinky	kinky.
Hymen	Hymen.
Black	Black.
Fagot	Fagot.
kafir	kafir.
adult	adult.
Nigre	Nigre.
skank	skank.
angie	angie.
Pu55i	Pu55i.
lugan	lugan.
Slopy	Slopy.
Bogan	Bogan.
Mggor	Mggor.
Pu55y	Pu55y.
crime	crime.
Knife	Knife.
felch	felch.
drunk	drunk.
cocky	cocky.
smack	smack.
demon	demon.
seppo	seppo.
Kinky	Kinky.
kraut	kraut.
sadis	sadis.
Cra5h	
sadom	sadom.
allah	allah.
Trots	Trots.
fubar	fubar.
peni5	peni5.
pu55i	pu55i.
whore	whore.
Peni5	
Bombs	Bombs.
Lezzo	Lezzo.
teste	teste.
roach	roach.
joint	joint.
eatme	eatme.
Bunga	Bunga.
dildo	dildo.
hymen	hymen.
Shoot	Shoot.
angry	angry.
Sluts	Sluts.
Pommy	Pommy.
farty	farty.
fuuck	fuuck.
death	death.
vomit	vomit.
Shhit	Shhit.
argie	argie.
Twink	Twink.
Panti	Panti.
jizim	jizim.
pikey	pikey.
Cocky	Cocky.
Sexed	Sexed.
slime	slime.
Nigra	Nigra.
Booby	Booby.
Joint	Joint.
nigra	nigra.
crabs	crabs.
crack	crack.
porno	porno.
Argie	Argie.
knife	knife.
Chink	Chink.
Blind	Blind.
Crack	Crack.
Kotex	Kotex.
Crime	Crime.
Squaw	Squaw.
Prick	Prick.
pocha	pocha.
nasty	nasty.
nigre	nigre.
gyppy	gyppy.
Erect	Erect.
Jebus	Jebus.
Demon	Demon.
queer	queer.
Niger	Niger.
bunga	bunga.
pussy	pussy.
randy	randy.
Enema	Enema.
Gross	Gross.
Limey	Limey.
fairy	fairy.
Balls	Balls.
rabbi	rabbi.
honky	honky.
Jiggy	Jiggy.
forni	forni.
slant	slant.
boong	boong.
Asses	Asses.
Bible	Bible.
Mafia	Mafia.
mocky	mocky.
moles	moles.
Jesus	Jesus.
Dirty	Dirty.
asses	asses.
limey	limey.
Gubba	Gubba.
Darky	Darky.
Pocha	Pocha.
prick	prick.
idiot	idiot.
Bitch	Bitch.
erect	erect.
jihad	jihad.
Hussy	Hussy.
Faith	Faith.
titty	titty.
Satan	Satan.
devil	devil.
blind	blind.
necro	necro.
Slime	Slime.
Osama	Osama.
satan	satan.
booty	booty.
pubic	pubic.
Adult	Adult.
sluts	sluts.
cohee	cohee.
gyppo	gyppo.
latin	latin.
Boner	Boner.
Jihad	Jihad.
Pansy	Pansy.
Skank	Skank.
Mgger	Mgger.
Sooty	Sooty.
shoot	shoot.
sperm	sperm.
nymph	nymph.
lesbo	lesbo.
chink	chink.
ikey	ikey.
jigg	jigg.
bomd	bomd.
Hell	Hell.
Paki	Paki.
Skum	Skum.
Nook	Nook.
Anal	Anal.
dope	dope.
Rere	Rere.
Hoes	Hoes.
turd	turd.
Fore	Fore.
meth	meth.
fuck	fuck.
scum	scum.
Piky	Piky.
whiz	whiz.
Piss	Piss.
tard	tard.
bast	bast.
cunt	cunt.
nazi	nazi.
mams	mams.
Hole	Hole.
Pimp	Pimp.
Nuke	Nuke.
Cock	Cock.
Babe	Babe.
Slut	Slut.
Fear	Fear.
abbo	abbo.
spig	spig.
pimp	pimp.
jism	jism.
rere	rere.
kunt	kunt.
scag	scag.
slav	slav.
hork	hork.
orga	orga.
Wank	Wank.
Pube	Pube.
laid	laid.
Pric	Pric.
Arab	Arab.
Kink	Kink.
peck	peck.
Mofo	Mofo.
Pixy	Pixy.
cock	cock.
Floo	Floo.
dong	dong.
skum	skum.
Jizm	Jizm.
groe	groe.
muff	muff.
pohm	pohm.
krap	krap.
Jism	Jism.
shav	shav.
Spig	Spig.
Koon	Koon.
Dead	Dead.
Pi55	Pi55.
Cunt	Cunt.
Lies	Lies.
chav	chav.
Moky	Moky.
boom	boom.
jiga	jiga.
Dike	Dike.
Sexy	Sexy.
Gypo	Gypo.
Nazi	Nazi.
Butt	Butt.
gypo	gypo.
pixy	pixy.
Doom	Doom.
cumm	cumm.
teat	teat.
blow	blow.
hore	hore.
heeb	heeb.
jugs	jugs.
phuq	phuq.
cigs	cigs.
Hore	Hore.
Bong	Bong.
hebe	hebe.
phuk	phuk.
Arse	Arse.
snot	snot.
butt	butt.
alla	alla.
pric	pric.
Porn	Porn.
jizm	jizm.
Drug	Drug.
oral	oral.
Poop	Poop.
Tard	Tard.
Burn	Burn.
Died	Died.
piss	piss.
Perv	Perv.
Fire	Fire.
poon	poon.
doom	doom.
Jade	Jade.
Jigg	Jigg.
Kill	Kill.
Pros	Pros.
Poon	Poon.
Blow	Blow.
damn	damn.
dago	dago.
kums	kums.
vibr	vibr.
Puss	Puss.
Shat	Shat.
Crap	Crap.
Tits	Tits.
Clit	Clit.
shag	
hell	hell.
bomb	bomb.
dumb	dumb.
Munt	Munt.
tits	tits.
Wetb	Wetb.
fear	fear.
nude	nude.
jizz	jizz.
anus	anus.
Meth	Meth.
Gook	Gook.
Dink	Dink.
boob	boob.
spik	spik.
Geez	Geez.
Lezz	Lezz.
Honk	Honk.
kike	kike.
Dyke	Dyke.
Taff	Taff.
nook	nook.
Phuq	Phuq.
kill	kill.
Scat	Scat.
Dago	Dago.
slut	slut.
milf	milf.
Shav	Shav.
Hebe	Hebe.
whop	whop.
spic	spic.
wetb	wetb.
Slav	Slav.
porn	porn.
scat	scat.
Homo	Homo.
drug	drug.
Whiz	Whiz.
Dive	Dive.
dego	dego.
barf	barf.
payo	payo.
lies	lies.
Horn	Horn.
Shag	Shag.
Hapa	Hapa.
Jeez	Jeez.
pi55	pi55.
puss	puss.
Spit	Spit.
Cigs	Cigs.
whit	whit.
ra8s	ra8s.
Jizz	Jizz.
perv	perv.
died	died.
Spik	Spik.
Pusy	Pusy.
honk	honk.
Groe	Groe.
rump	rump.
shit	shit.
Krap	Krap.
Limy	Limy.
nigr	nigr.
Oral	Oral.
dyke	dyke.
dead	dead.
Hobo	Hobo.
Chav	Chav.
Boom	Boom.
Shit	Shit.
Kock	Kock.
fart	fart.
Dick	Dick.
poop	poop.
Dumb	Dumb.
geni	geni.
hoes	hoes.
mofo	mofo.
Whit	Whit.
pube	pube.
Kyke	Kyke.
fuks	fuks.
dick	dick.
orgy	orgy.
Nigg	Nigg.
burn	burn.
Kums	Kums.
spit	spit.
anal	anal.
hole	hole.
twat	twat.
piky	piky.
Suck	Suck.
Tang	Tang.
Heeb	Heeb.
taff	taff.
arab	arab.
tang	tang.
Nude	Nude.
babe	babe.
nuke	nuke.
Vibr	Vibr.
wuss	wuss.
Dies	Dies.
pusy	pusy.
fore	fore.
moky	moky.
Dong	Dong.
Smut	Smut.
Nigr	Nigr.
cunn	cunn.
Coon	Coon.
gypp	gypp.
kink	kink.
Laid	Laid.
jeez	jeez.
sick	sick.
koon	koon.
puke	puke.
arse	arse.
Sick	Sick.
Payo	Payo.
Milf	Milf.
hobo	hobo.
Pudd	Pudd.
Itch	Itch.
Cumm	Cumm.
Scag	Scag.
Dego	Dego.
Kike	Kike.
suck	suck.
horn	horn.
Orgy	Orgy.
pros	pros.
lezz	lezz.
Anus	Anus.
Dope	Dope.
munt	munt.
Barf	Barf.
Cunn	Cunn.
Fart	Fart.
Twat	Twat.
Ikey	Ikey.
Whop	Whop.
Jugs	Jugs.
Turd	Turd.
Jiga	Jiga.
Peck	Peck.
hapa	hapa.
Phuk	Phuk.
Gipp	Gipp.
Puke	Puke.
Ra8s	Ra8s.
paki	paki.
dies	dies.
limy	limy.
deth	deth.
Muff	Muff.
Quim	Quim.
Hook	Hook.
Bomb	Bomb.
Wuss	Wuss.
Scum	Scum.
Chin	Chin.
Spic	Spic.
Boob	Boob.
fire	fire.
hook	hook.
dike	dike.
kock	kock.
nigg	nigg.
coon	coon.
sexy	sexy.
Rump	Rump.
Fuck	Fuck.
clit	clit.
Fuks	Fuks.
dink	dink.
shat	shat.
kyke	kyke.
smut	smut.
floo	floo.
Deth	Deth.
chin	chin.
Orga	Orga.
Abbo	Abbo.
pudd	pudd.
itch	itch.
Rape	Rape.
jade	jade.
gook	gook.
Bomd	Bomd.
Damn	Damn.
Alla	Alla.
Snot	Snot.
wank	wank.
Bast	Bast.
rape	rape.
homo	homo.
crap	crap.
quim	quim.
Pohm	Pohm.
Kunt	Kunt.
bong	bong.
dive	dive.
Teat	Teat.
Hork	Hork.
Geni	Geni.
Mams	Mams.
geez	geez.
gipp	gipp.
Gypp	Gypp.
jew	jew.
Uck	Uck.
jiz	jiz.
gob	gob.
Pud	Pud.
sob	sob.
God	God.
sex	sex.
Ass	Ass.
pot	pot.
Xxx	Xxx.
Poo	Poo.
dix	dix.
nip	nip.
Wog	Wog.
kkk	kkk.
nig	nig.
Goy	Goy.
gin	gin.
poo	poo.
Sob	Sob.
Fuc	Fuc.
Xtc	Xtc.
wop	wop.
Gay	Gay.
pee	pee.
Dix	Dix.
Jew	Jew.
wab	wab.
Mad	Mad.
pud	pud.
ero	ero.
Sex	Sex.
fat	fat.
hiv	hiv.
Evl	Evl.
jap	jap.
tnt	tnt.
Tit	Tit.
gun	gun.
wtf	wtf.
Pom	Pom.
Lez	Lez.
Gob	Gob.
goy	goy.
Fuk	Fuk.
uck	uck.
Fat	Fat.
bra	bra.
Tnt	Tnt.
cum	cum.
wog	wog.
ass	ass.
Kkk	Kkk.
Pee	Pee.
Jap	Jap.
Abo	Abo.
Cum	Cum.
Nip	Nip.
sos	sos.
pom	pom.
xtc	xtc.
tit	tit.
Gyp	Gyp.
fuk	fuk.
evl	evl.
xxx	xxx.
Gun	Gun.
Kid	Kid.
fok	fok.
mad	mad.
Sos	Sos.
Fok	Fok.
Gin	Gin.
kum	kum.
Fag	Fag.
Wab	Wab.
abo	abo.
die	die.
kid	kid.
gyp	gyp.
Hiv	Hiv.
lsd	lsd.
gay	gay.
god	god.
Nig	Nig.
Bra	Bra.
Jiz	Jiz.
Pot	Pot.
Wop	Wop.
Kum	Kum.
Lsd	Lsd.
lez	lez.
fag	fag.
Wtf	Wtf.
fuc	fuc.
Ero	Ero.
Die	Die.
uk	uk.
wn	wn.
ho	ho.
ky	ky.
Wn	Wn.
Uk	Uk.
fu	fu.
Ky	Ky.
bi	bi.
Bi	Bi.
Ho	Ho.
Fu	Fu.
