original	new
Gaymuthafuckinwhore	Gaymuhtafuckinwhore
gaymuthafuckinwhore	gaymuthafuckinwhroe
Goddamnmuthafucker	Goddamnmuthaufcker
goddamnmuthafucker	ogddamnmuthafucker
mattressprincess	mattressprinecss
Mattressprincess	Mattresspricness
spaghettibender	spagehttibender
spaghettinigger	spahgettinigger
Spaghettibender	pSaghettibender
devilworshipper	edvilworshipper
niggardliness's	niggardlienss's
Spaghettinigger	Sapghettinigger
Devilworshipper	Dveilworshipper
Niggardliness's	Niggardlines'ss
Motherfuckings	Motehrfuckings
Poorwhitetrash	Poorwhiettrash
spankthemonkey	spanktehmonkey
smackthemonkey	smackthemoneky
purinapricness	purinarpicness
Motherlovebone	Motherloevbone
Luckycammeltoe	Luckcyammeltoe
Purinapricness	Purinaprciness
motherfuckings	motherfukcings
motherlovebone	motherolvebone
Spankthemonkey	Spankhtemonkey
poorwhitetrash	poorwhitterash
Smackthemonkey	Smcakthemonkey
luckycammeltoe	luckycammetloe
Alligatorbait	Alligatobrait
jacktheripper	jackthreipper
Tongethruster	Tongethurster
Carpetmuncher	Carpetumncher
shitforbrains	shitforbraisn
fingerfucking	fingerfcuking
Motherfucking	Motherfucknig
pooperscooper	opoperscooper
Masterblaster	Masterblasetr
dickforbrains	dickforbrians
Jacktheripper	Jackthreipper
Fingerfuckers	Fingerfuckres
fingerfuckers	fingerfuckesr
Pooperscooper	Pooprescooper
Fingerfucking	Fingerfucknig
niggardliness	niggadrliness
carpetmuncher	carpetmucnher
virginbreaker	virgnibreaker
Shitforbrains	Shtiforbrains
pearlnecklace	eparlnecklace
Virginbreaker	Vriginbreaker
Assassination	Assasisnation
shitoutofluck	shitoutoflukc
Niggardliness	Niggardlniess
assassination	sasassination
tongethruster	tongethurster
Mothafuckings	Mohtafuckings
mothafuckings	mtohafuckings
Shitoutofluck	Shitouotfluck
masterblaster	masterbalster
alligatorbait	alligtaorbait
Dickforbrains	Dikcforbrains
motherfucking	motherfuckign
Pearlnecklace	Pearlneclkace
Pussypounder	Pussyopunder
Heterosexual	Hetersoexual
transvestite	transvsetite
freakyfucker	freaykfucker
Conservative	Consrevative
masturbating	masturbatnig
Fingerfucked	Fignerfucked
motherfucker	mothefrucker
Transvestite	Transvesttie
Pornprincess	Ponrprincess
pussypounder	pussypuonder
pornprincess	oprnprincess
Cherrypopper	hCerrypopper
motherfucked	mohterfucked
Mothafucking	Mothafucikng
grostulation	grsotulation
Goldenshower	Godlenshower
fingerfucker	ifngerfucker
Fuckingbitch	Fuckignbitch
Titbitnipply	Titbitniplpy
crotchmonkey	rcotchmonkey
tunneloflove	tunnelofloev
Timbernigger	Timbernigegr
Spermhearder	Spermeharder
Motherfuckin	Motherfuckni
crotchjockey	crotchjockye
Trailertrash	Tarilertrash
Motherfucker	Mothrefucker
Motherfucked	Mohterfucked
williewanker	wliliewanker
Fingerfucker	Fignerfucker
fingerfucked	fingerfukced
trailertrash	trailertrsah
Tunneloflove	Tunnelfolove
tonguethrust	tonguethrsut
motherfuckin	mothefruckin
Masturbating	Mastrubating
Crotchmonkey	Crocthmonkey
butt-fuckers	butt-fucekrs
mothafucking	mothafuckign
goldenshower	goldensohwer
stupidfucker	sutpidfucker
Freakyfucker	Freakyfuckre
Stupidfucker	Stuipdfucker
Lezbefriends	Lezberfiends
athletesfoot	athletesfoot
Williewanker	iWlliewanker
timbernigger	itmbernigger
spermhearder	spermhaerder
fuckingbitch	fuckignbitch
Athletesfoot	tAhletesfoot
nofuckingway	nofuckingwya
cherrypopper	chrerypopper
Crotchjockey	Crotcjhockey
beatyourmeat	beatyouremat
titbitnipply	titbitnipply
heterosexual	heterosexaul
Butt-fuckers	Butt-fuckers
lezbefriends	lezbferiends
Beatyourmeat	Beaytourmeat
Nofuckingway	Nofukcingway
Tonguethrust	Tonguetrhust
Grostulation	Grostultaion
conservative	conservaitve
crack-whore	carck-whore
sonofabitch	sonofabicth
Mothafuckaz	Mothafucakz
Shithappens	Shithappnes
doggiestyle	doggisetyle
Junglebunny	Junglebunyn
cuntlicking	cutnlicking
Intercourse	Intercuorse
Twobitwhore	Twoibtwhore
Fudgepacker	Fudgepacekr
tonguetramp	otnguetramp
pussyfucker	pussyfukcer
homobangers	homobangesr
mothafuckin	mohtafuckin
Butt-fucker	Butt-fucker
Doggiestyle	Doggiestyel
mooncricket	moocnricket
Ejaculating	Ejaculatign
Fistfucking	Fisftucking
Backdoorman	Backdoorman
Penetration	Penetratino
Pussyfucker	Pussfyucker
executioner	executioenr
Crack-whore	Crack-whoer
whiskeydick	whiskeydikc
Whorefucker	Whoerfucker
junglebunny	jnuglebunny
Fuckinright	Fuckinrgiht
spreadeagle	spreadealge
Cunillingus	Cunillignus
Holestuffer	Holestuffer
Buttfuckers	Butftuckers
ejaculation	ejaculatoin
Cuntlicking	Cunlticking
intercourse	itnercourse
Fannyfucker	Fannfyucker
Pussylicker	Pussylikcer
porchmonkey	prochmonkey
Beastiality	Beastaility
snatchpatch	snatchpacth
kunnilingus	kuninlingus
Mothafuckin	Mothaufckin
beastiality	ebastiality
molestation	moletsation
Whitenigger	hWitenigger
Molestation	Molesattion
cyberslimer	ycberslimer
mothafucker	mtohafucker
Buttmuncher	Buttmucnher
interracial	interracila
fistfucking	fitsfucking
fudgepacker	fudgepcaker
ejaculating	ejaculaitng
whorefucker	whorefuckre
Kunnilingus	Kunnilingus
Spermherder	Spermehrder
Cunnilingus	Cunnilingus
Tonguetramp	Tonguetarmp
slimebucket	slimebucekt
cockblocker	cockbolcker
Slimebucket	Slmiebucket
Snatchpatch	Snatchaptch
Whiskeydick	Whiskeyidck
buttmuncher	buttmunchre
Cameljockey	Cmaeljockey
Dingleberry	Dingelberry
Mastrabator	Matsrabator
Glazeddonut	Galzeddonut
transsexual	transsxeual
Cockblocker	oCckblocker
shithappens	shitahppens
cunnilingus	cuninlingus
pussylicker	pussyilcker
palestinian	palestiinan
slavedriver	slavedrievr
Meatbeatter	Metabeatter
Executioner	Exceutioner
twobitwhore	twboitwhore
Pornography	Pornogarphy
butt-fucker	btut-fucker
cocksucking	cockscuking
Cocksucking	Cocksuckign
Breastlover	Berastlover
Ejaculation	Ejaculatino
pornography	pronography
cameljockey	caemljockey
whitenigger	whitenigger
Jesuschrist	Jesushcrist
Interracial	Interracial
spermherder	spermherdre
jesuschrist	jeusschrist
cunillingus	cunillinugs
Mothafucker	Mothafucekr
dingleberry	dnigleberry
mothafuckaz	omthafuckaz
Sonofabitch	Sonofbaitch
Cyberslimer	Cybersilmer
Palestinian	Palestiinan
skankybitch	skankbyitch
barelylegal	baerlylegal
mastrabator	mastrabtaor
Skankywhore	Skanykwhore
meatbeatter	meatebatter
Slavedriver	Slvaedriver
fuckinright	fuciknright
muffindiver	mufifndiver
Skankybitch	Sknakybitch
Transsexual	Trasnsexual
penetration	pneetration
buttfuckers	buttfuckres
backdoorman	abckdoorman
mothafucked	mohtafucked
breastlover	breastlvoer
fannyfucker	fannyfuckre
Hillbillies	Hillibllies
assassinate	assassniate
Mothafucked	Mohtafucked
Muffindiver	Muffindivre
hillbillies	ihllbillies
holestuffer	ohlestuffer
Barelylegal	Barellyegal
Homobangers	Homobanegrs
Porchmonkey	Porchmokney
glazeddonut	glazeddontu
skankywhore	skanykwhore
Assassinate	Assassinaet
Mooncricket	oMoncricket
Spreadeagle	Spreadaegle
fingerfood	fignerfood
fuckmehard	fukcmehard
Deepthroat	Deeptrhoat
Mothafucka	Mohtafucka
Transexual	rTansexual
Footaction	Footcation
Lovemuscle	Lovmeuscle
fingerfuck	fignerfuck
fistfucked	ifstfucked
deapthroat	deapthrota
bumblefuck	ubmblefuck
Motherfuck	oMtherfuck
Fuckmehard	uFckmehard
nastybitch	nastbyitch
footfucker	footufcker
Loverocket	Loverockte
assblaster	assblastre
Snownigger	Snonwigger
fuckinnuts	fuckinntus
pickaninny	picknainny
deepthroat	depethroat
protestant	protestatn
Butchbabes	Butcbhabes
bestiality	ebstiality
assmuncher	assmuncehr
cuntfucker	cuntfuckre
sandnigger	sandngiger
masturbate	amsturbate
doggystyle	odggystyle
Niggarding	Niggaridng
Doggystyle	Doggysytle
masterbate	masterbaet
Sandnigger	Sandngiger
Masterbate	Masterbaet
Mufflikcer	Mufflikecr
Cocksmoker	Ccoksmoker
mufflikcer	mufflikcre
footlicker	fotolicker
Fourtwenty	Fourtwnety
Pocketpool	Pockeptool
flatulence	flatluence
sixtyniner	sitxyniner
Shawtypimp	Shawtpyimp
shawtypimp	shawtypmip
asspuppies	asspuppies
samckdaddy	samckadddy
children's	cihldren's
sniggering	sniggreing
Flatulence	Faltulence
Lovepistol	Lovepistlo
Palesimian	aPlesimian
pussyeater	pussyeaetr
Headlights	Headilghts
Bigbastard	iBgbastard
sleezeball	sleezeabll
Fingerfuck	Fingerufck
greaseball	graeseball
lovemuscle	loveumscle
suckmydick	sukcmydick
Mickeyfinn	Mcikeyfinn
republican	republicna
dicklicker	dicklicekr
Sonofbitch	Sonofbtich
Balllicker	Blallicker
Propaganda	Porpaganda
Beastality	Beastaliyt
whiskydick	whiskydikc
cocksmoker	cocksmokre
gangbanged	gagnbanged
Gangbanged	Ganbganged
fourtwenty	forutwenty
Bestiality	Bestialtiy
transexual	tranesxual
propaganda	propaagnda
facefucker	fcaefucker
Fistfucker	iFstfucker
Dicklicker	Dikclicker
kunilingus	uknilingus
Cuntfucker	Cuntfuckre
Cocklicker	Cocklciker
pussylover	pussylovre
Shitfucker	Shtifucker
cocklicker	cokclicker
Suckmydick	Sukcmydick
peckerwood	peckewrood
Niggaracci	Niggaracic
Gangbanger	Gagnbanger
mothafucka	mtohafucka
Pussylover	Pussylover
beastality	beatsality
footaction	fooatction
Homosexual	Homsoexual
Peckerwood	Pecekrwood
snownigger	nsownigger
nipplering	inpplering
Nastybitch	aNstybitch
Australian	Autsralian
gonorrehea	gonorrehae
pocketpool	pocketpool
Sixtyniner	Sixtynienr
cocksucker	cocksucekr
Whitetrash	Whitetrahs
Footfucker	Fooftucker
Facefucker	Faceufcker
Sleezeball	Sleezeball
Cuntsucker	Cutnsucker
loverocket	loverokcet
crackwhore	crackwohre
Stupidfuck	Stupidfukc
Cuntlicker	uCntlicker
stupidfuck	stupidfcuk
Gonorrehea	Gonrorehea
Spermacide	Spermacdie
cunilingus	cunilignus
Unfuckable	nUfuckable
prostitute	prostittue
gangbanger	gangbangre
niggaracci	niggraacci
Fistfucked	Fitsfucked
nastywhore	nastywhroe
Children's	Chlidren's
skankbitch	skanbkitch
conspiracy	conspirayc
corruption	corrpution
Deapthroat	Deapthraot
sonofbitch	sonobfitch
Fuckinnuts	Fuckinntus
Skankbitch	Skankibtch
motherfuck	motehrfuck
cuntlicker	cnutlicker
buttfucker	buttfuckre
Crackwhore	Crackwhroe
clamdigger	clamdgiger
shithapens	shithapesn
Greaseball	Graeseball
australian	ausrtalian
zipperhead	zippehread
cockcowboy	cockcwoboy
piccaninny	piccaninny
balllicker	balllickre
mickeyfinn	mcikeyfinn
Assblaster	Assblaster
bigbastard	bigbastrad
homosexual	homosxeual
Niggerhole	Niggerohle
Corruption	Corruption
cuntsucker	cuntuscker
Chickslick	Chcikslick
Fuckmonkey	Fuckmokney
fuckfriend	fuckfrined
Pussyeater	Pussyeaetr
Protestant	Prtoestant
Prostitute	Protsitute
Whorehouse	hWorehouse
Cocksucked	Cocksucekd
whitetrash	whtietrash
mastabater	mastabtaer
Cunilingus	Cunilignus
niggerhole	inggerhole
cocksucked	occksucked
Masturbate	Mastubrate
niggerhead	niggehread
headlights	headlihgts
Buttpirate	Buttpiraet
Republican	eRpublican
Kunilingus	Kunilingsu
lovepistol	lovpeistol
Nipplering	Nipplerign
Conspiracy	Cosnpiracy
Piccaninny	Piccanniny
spermacide	spermacdie
Niggerhead	Niggerhead
Zipperhead	iZpperhead
Shithapens	Shithaepns
Sniggering	Sniggernig
Fuckfriend	Fcukfriend
Skankwhore	kSankwhore
Clamdigger	Cladmigger
Buttfucker	Buttfcuker
Mastabater	Matsabater
buttpirate	buttpirtae
fuckmonkey	fuckmoneky
chickslick	chickslcik
niggarding	niggadring
fistfucker	fisftucker
unfuckable	nufuckable
Cocksucker	Cocksuckre
Assmuncher	Assmnucher
Bumblefuck	Bubmlefuck
Fingerfood	Fignerfood
Cockcowboy	Cocckowboy
shitfucker	shitfcuker
ejaculated	jeaculated
Ejaculated	Ejacualted
butchbabes	butchbbaes
skankwhore	skankwhroe
Nastywhore	Natsywhore
Asspuppies	Assupppies
Pickaninny	Picknainny
Samckdaddy	Samckdadyd
whorehouse	whroehouse
Footlicker	Footlickre
Whiskydick	Whiskdyick
palesimian	paleismian
shortfuck	shortfukc
cocksmith	occksmith
Assfucker	Assufcker
marijuana	marijuaan
butchdike	bucthdike
Asslicker	Asslickre
pornflick	pornflcik
cockblock	cockbolck
Titfucker	iTtfucker
cumbubble	cumbubbel
Slaughter	Salughter
picaninny	ipcaninny
Sniggered	Sniggeerd
Rearentry	Reaerntry
Breastjob	Bresatjob
fuckfreak	fcukfreak
fatfucker	aftfucker
titfuckin	titfucikn
disturbed	disutrbed
Asscowboy	Assocwboy
cumjockey	cumjcokey
ethiopian	etihopian
Marijuana	aMrijuana
Nigerians	Ngierians
assbagger	assabgger
fornicate	fronicate
upthebutt	uptheubtt
magicwand	magciwand
Feltching	Felthcing
Shitfaced	Sihtfaced
Loadedgun	Loadedgnu
Penthouse	Pentohuse
Sexy-slim	Sexy-silm
Analannie	Analannie
slideitin	slieditin
snigger's	sniggers'
Suckmytit	Suckymtit
Buttmunch	Butmtunch
Trisexual	Triesxual
explosion	explsoion
Assranger	Asrsanger
sweetness	sweetness
Cocklover	Cokclover
Goddamnit	Goddamnit
Stripclub	Stripclbu
Magicwand	Magiwcand
pimpjuice	pimpjuiec
Crackpipe	Cracpkipe
buttstain	butsttain
Titlicker	Titlciker
Horseshit	Hosreshit
bountybar	bonutybar
pussylips	pusyslips
swallower	swalloewr
lovejuice	loevjuice
Suckmyass	Scukmyass
Shithouse	Shithuose
Freakfuck	Freakfukc
Primetime	Primetiem
sniggered	sniggered
Ethiopian	tEhiopian
asscowboy	asscobwoy
Buttstain	uBttstain
execution	xeecution
rearentry	raerentry
Asskisser	Asskisser
Ejaculate	Ejacluate
Dixiedyke	Dxiiedyke
stripclub	stripclbu
ejaculate	ejacultae
goddammit	goddmamit
Slutwhore	Slutwhroe
hitlerist	hilterist
Catholics	Catohlics
Moneyshot	oMneyshot
asskisser	asskisesr
skinflute	siknflute
testicles	testiclse
slimeball	slmieball
Bootycall	Booytcall
dumbbitch	dubmbitch
nigerians	nigeriasn
fuckbuddy	fuckubddy
Cumjockey	Cumjoceky
Sweetness	Sweetnses
cockqueen	cocqkueen
Cocktease	Cocktesae
skankfuck	skankfukc
pubiclice	pubicliec
Mastabate	Mastbaate
asslicker	saslicker
prickhead	prickehad
Cockrider	Cockriedr
mastabate	masatbate
Cigarette	Cigarette
clamdiver	clamdievr
Kumbullbe	Kumblulbe
gatorbait	gatorbiat
Nastyslut	Nastylsut
Threesome	Threesmoe
niggardly	ngigardly
Swallower	wSallower
niggarded	ngigarded
criminals	cirminals
penthouse	epnthouse
cocklover	cockolver
Sleezebag	Sleezbeag
yellowman	yellowmna
Clamdiver	Clamdievr
dixiedike	dixiediek
slaughter	slaughtre
niggard's	inggard's
towelhead	towelheda
Fuckbuddy	Fukcbuddy
primetime	primetiem
feltching	fetlching
goddamned	godadmned
bitchslap	bicthslap
nigglings	nigglnigs
slutwhore	slutwohre
Fornicate	Fonricate
sexkitten	sexktiten
Premature	rPemature
titlicker	ttilicker
Dumbbitch	Dumbbithc
bi-sexual	bi-esxual
assmonkey	asmsonkey
Communist	Communist
butt-fuck	btut-fuck
Christian	Chritsian
Muffdiver	Muffidver
Mothafuck	Mohtafuck
Fuckfreak	uFckfreak
goddamnit	goddamnti
sixsixsix	sixsisxix
goddamnes	goddmanes
dickbrain	dickbarin
Testicles	eTsticles
Butt-bang	But-tbang
kumbullbe	kmubullbe
shitfaced	shitfaecd
Hitlerism	Hitleirsm
Disturbed	Disturbde
damnation	damnatino
Execution	Eexcution
butchdyke	ubtchdyke
Niggardly	Niggardyl
Terrorist	Terrorist
suckmytit	sucmkytit
Fatfucker	aFtfucker
Dragqueen	Dragqeuen
asspacker	saspacker
Butchdyke	Buthcdyke
Dixiedike	Dixeidike
Dragqween	Dragqwene
Towelhead	Towlehead
butt-bang	butt-bagn
Assmonkey	Assomnkey
Bicurious	Biucrious
assfucker	assfucekr
Splittail	Splittial
shitstain	sihtstain
slopehead	lsopehead
Explosion	Expolsion
Asspacker	Asspcaker
buttmunch	buttumnch
cocktease	cockteaes
Kumbubble	Kumbubble
threesome	threeosme
freakfuck	frekafuck
Upthebutt	Utphebutt
sexy-slim	sxey-slim
Crotchrot	Crotchort
Nigglings	Nigglings
Sixtynine	Sixytnine
asspirate	asspirtae
cockrider	cocrkider
Pornflick	Pornflcik
Criminals	rCiminals
premature	prematrue
dragqween	drgaqween
Skinflute	Skinlfute
Yellowman	Yellowmna
Fuckwhore	Fuckwhoer
splittail	splittali
Cockfight	Ccokfight
Skankfuck	Skaknfuck
rentafuck	rentfauck
fuckwhore	fuckwhroe
Sexkitten	Sexkittne
Pimpjuice	Pimpjiuce
nutfucker	nuftucker
crotchrot	crocthrot
Butchdike	Butchdiek
Cockqueen	oCckqueen
hottotrot	hottotrot
Hijacking	Hiajcking
Rentafuck	Rentfauck
Titfuckin	Titufckin
analannie	analnanie
loadedgun	loadegdun
cigarette	cigartete
Hitlerist	Hitelrist
scallywag	scalylwag
moneyshot	moneyhsot
shiteater	shiteaetr
Bi-sexual	Bi-sexaul
dragqueen	dragquene
Cocksucer	Cocksucre
Shitstain	Shisttain
Hottotrot	Hottotrto
excrement	xecrement
christian	crhistian
breastjob	bresatjob
cockfight	ccokfight
Pubiclice	Pbuiclice
communist	communist
Cockblock	Cockbolck
suckmyass	scukmyass
hijacking	hijcaking
mothafuck	motahfuck
titfucker	tiftucker
Pussylips	Pusslyips
Assbagger	Assbagger
Damnation	Dmanation
sleezebag	slezeebag
bicurious	biucrious
Bountybar	Bounytbar
Excrement	Excremetn
horseshit	horssehit
Butt-fuck	Buttf-uck
Goddammit	Gdodammit
assranger	assragner
catholics	cathloics
shithouse	shithosue
kumbubble	kumbbuble
Cocksmith	Ccoksmith
Picaninny	Picaninny
Prickhead	Prickhaed
Cumbubble	Cumbubbel
Shortfuck	hSortfuck
Nutfucker	Nutufcker
Goddamned	oGddamned
Bitchslap	Bitchsalp
Goddamnes	Goddmanes
hitlerism	htilerism
cocksucer	cockuscer
thicklips	thiclkips
assjockey	asjsockey
sixtynine	sixytnine
Inthebuff	Itnhebuff
breastman	breastamn
Lovejuice	Lovejiuce
Scallywag	Scallwyag
Asspirate	Asspiarte
Niggard's	Niggadr's
Slimeball	Silmeball
trisexual	trsiexual
inthebuff	itnhebuff
bootycall	booytcall
dixiedyke	diixedyke
Gatorbait	Gaotrbait
Dickbrain	Dicbkrain
Thicklips	Thicklisp
Sixsixsix	Sixsxisix
Shiteater	hSiteater
muffdiver	muffdivre
Slideitin	Slidietin
nastyslut	nastsylut
Assjockey	Assjokcey
Snigger's	Snigger's
Breastman	Braestman
Slopehead	Sloephead
crackpipe	carckpipe
Niggarded	Nigagrded
terrorist	terrroist
narcotic	narctoic
Homicide	Homicied
Roundeye	Roudneye
Headfuck	eHadfuck
Threeway	hTreeway
hijacker	hjiacker
Sniggers	Sngigers
cockknob	occkknob
homicide	ohmicide
lapdance	lapadnce
cocktail	cocktali
diseases	disaeses
Buttplug	Buttplgu
Felching	Feclhing
niggards	ngigards
Phonesex	Pohnesex
bullshit	bullsiht
testicle	tetsicle
murderer	murdeerr
ballsack	blalsack
freefuck	rfeefuck
Footfuck	Fotofuck
cunteyed	cuntyeed
Foursome	oFursome
screwyou	scerwyou
Abortion	Abotrion
jackshit	ajckshit
muffdive	muffidve
buttface	buttafce
Fuckface	Fucfkace
vibrator	vibraotr
Copulate	Couplate
niggling	niggilng
sexhound	sexhonud
Bullcrap	Bullcarp
jizjuice	jzijuice
snowback	snowbakc
lovebone	loveboen
Filipino	Fiilpino
backseat	backesat
bisexual	biesxual
coloured	clooured
Eatpussy	Eatupssy
Butthead	Buthtead
fuckedup	fukcedup
Horniest	Horniets
sniggers	sngigers
Retarded	Retadred
Shagging	Shgaging
executed	exceuted
sodomize	sodomiez
cemetery	cmeetery
Criminal	Criimnal
Redlight	Redilght
playgirl	palygirl
Datnigga	Datngiga
Testicle	Tseticle
Givehead	Givheead
barfface	barffaec
Nigerian	Nigreian
filipina	filipian
sexhouse	sexhosue
Defecate	Deefcate
Cockhead	Cokchead
datnigga	datingga
Vietcong	Vitecong
shitface	shiftace
roundeye	roudneye
bunghole	ubnghole
chinamen	chinaemn
chinaman	cihnaman
Sodomise	Sdoomise
bullcrap	ubllcrap
fuckfest	fucfkest
Peepshow	Peepsohw
manhater	manahter
clitoris	ciltoris
Erection	Erectino
Filipina	Fliipina
Lapdance	Lapdanec
Jackshit	Jakcshit
Ballsack	Ballscak
thirdeye	thirdyee
Buttfuck	Buttufck
sexually	seuxally
Narcotic	Nracotic
Thirdeye	Thidreye
dripdick	dridpick
dickless	dickless
Assholes	Asshloes
Barfface	Brafface
Cocksuck	Ccoksuck
assmunch	asmsunch
Pussycat	Psusycat
Uptheass	Uptheass
Thirdleg	Thirdelg
Knockers	nKockers
Fuckable	Fuckalbe
Slutwear	Sluwtear
Mosshead	Mosshaed
spermbag	sperbmag
Shitlist	Shitilst
footfuck	fotofuck
fuckface	fuckfaec
retarded	ertarded
Lovebone	Lovbeone
foreskin	foreskni
Cunteyed	Cnuteyed
minority	mionrity
blackout	blackuot
Nigger's	Niggers'
Screwyou	Screwoyu
Sexhouse	Sehxouse
Bullshit	Blulshit
foursome	fousrome
stroking	stroikng
Tuckahoe	Tuckaohe
sexwhore	sexwohre
Spigotty	Spiogtty
buttbang	btutbang
footstar	footstar
syphilis	spyhilis
swastika	swastiak
Assassin	Assassni
canadian	canadain
gotohell	ogtohell
abortion	abortoin
Dickless	Dcikless
assklown	sasklown
Cumqueen	uCmqueen
pimpjuic	pimpjiuc
Arsehole	Arsehloe
Sexhound	Sexhonud
goddamit	godadmit
Bulldike	uBlldike
cocksman	ccoksman
Fuckhead	Fuckehad
Assclown	Asscolwn
defecate	defectae
Cockknob	Cockknob
Stringer	Srtinger
Dicklick	Dickilck
dicklick	diclkick
Coloured	Colorued
easyslut	eaysslut
Canadian	Canaidan
pornking	pornikng
buggered	buggeerd
gonzagas	gonzagsa
felching	eflching
Suckdick	uSckdick
Shitfull	Shitufll
Bisexual	Biseuxal
blackman	blackamn
fellatio	felltaio
Jizjuice	Jijzuice
Dumbfuck	Dumbfcuk
Cemetery	Ceemtery
godammit	gdoammit
mosshead	msoshead
Cocktail	oCcktail
fuckknob	fukcknob
Spermbag	pSermbag
Fucktard	Fcuktard
molestor	molsetor
shitdick	shitidck
Dickweed	Dickewed
Manpaste	Mapnaste
Sodomite	Sdoomite
beastial	beastila
Executed	Executde
Vibrator	Vibartor
vibrater	vibraetr
cockhead	cokchead
knockers	knocekrs
nigerian	nigeiran
Muffdive	Muffidve
molester	molestre
Asswhore	Asswohre
hotpussy	hotpusys
Radicals	Radicasl
Italiano	Itailano
Fuckfest	Fucfkest
shitlist	sihtlist
vietcong	veitcong
phukking	phukikng
Fuckedup	Fucekdup
european	euorpean
Sodomize	Sodoimze
Buggered	Bugegred
Chinaman	Chinaamn
nigger's	ngiger's
Gotohell	Goothell
Diseases	Diseasse
Easyslut	Esayslut
Slanteye	Salnteye
slanteye	slanteey
shagging	hsagging
lingerie	lnigerie
Jijjiboo	Jijjiboo
Sexwhore	Sexwohre
violence	ivolence
Shitting	hSitting
bulldike	bulldiek
Minority	Minoirty
Blackout	Blackotu
shitfuck	hsitfuck
pimpsimp	pimpsmip
Lingerie	Lingerei
Assmunch	Assmucnh
Dipstick	Dipsitck
Dickhead	Dickehad
Feltcher	Felcther
Bulldyke	Bluldyke
threeway	threewya
Sexymoma	Sexyomma
Godammit	Godamimt
Fuckknob	Fuckknbo
erection	eretcion
pussycat	pusscyat
Swastika	Swsatika
slutwear	sltuwear
Titlover	Titlovre
cuntlick	cuntilck
shitfull	shitfull
Foreskin	Froeskin
cybersex	cybersxe
Clitoris	Ciltoris
Limpdick	Limpdcik
Phukking	Puhkking
cornhole	cronhole
Gangbang	Gagnbang
meatrack	maetrack
Japanese	Japanees
Fistfuck	Fisftuck
Buttbang	Buttabng
buttfuck	buttfukc
Violence	Violecne
Murderer	Murdreer
Bunghole	Bugnhole
fucktard	fucktrad
European	Eruopean
cuntfuck	cutnfuck
Shooting	Shooting
beat-off	ebat-off
givehead	gievhead
japanese	japansee
Asslover	Aslsover
Shithead	Shithaed
Cornhole	Cornhoel
Assklown	Assklwon
ontherag	otnherag
showtime	shotwime
tuckahoe	tukcahoe
israel's	isarel's
spigotty	spgiotty
suckdick	suckidck
fuckhead	fuchkead
Sexually	eSxually
criminal	criimnal
headfuck	ehadfuck
Shitface	Shitfcae
Shitdick	Shitdcik
Ontherag	Ontehrag
Niggards	Ngigards
Beat-off	Bea-toff
intheass	inthaess
sodomite	sodmoite
sodomise	sodomies
sexymoma	sxeymoma
Footstar	Footsatr
Intheass	Inthesas
Beastial	Beatsial
butthead	btuthead
Pimpsimp	Pimpsmip
phonesex	phonesxe
Hijacker	Hijackre
Fastfuck	Fsatfuck
Showtime	Shwotime
asslover	assloevr
Pimpjuic	Pipmjuic
Goddamit	Goddaimt
Pisshead	Psishead
shithead	shitehad
jijjiboo	jijjiboo
Pornking	Porkning
Chinamen	Chianmen
dumbfuck	udmbfuck
uptheass	uptheass
gangbang	agngbang
Manhater	Manhaetr
filipino	filiipno
Henhouse	Henhosue
Gonzagas	Gonzaags
american	maerican
titlover	ttilover
Bitching	Bitchign
Molester	oMlester
eatballs	eatblals
eatpussy	etapussy
dipstick	dipstcik
Playgirl	Plagyirl
Sexslave	Sexlsave
shooting	shootnig
Vibrater	iVbrater
Dripdick	Drpidick
radicals	radiacls
Cuntfuck	Cunftuck
asswhore	aswshore
poontang	poontang
cumqueen	cuqmueen
Snowback	nSowback
assclown	asscolwn
Slutting	Sltuting
pisshead	pisshead
Cocksman	Cockmsan
Fellatio	eFllatio
bazongas	bazonags
Cameltoe	aCmeltoe
Hotpussy	Hoptussy
American	Ameriacn
assassin	asssasin
Bazongas	Bzaongas
cocksuck	cockusck
henhouse	henhoues
sexslave	esxslave
backdoor	bcakdoor
Backseat	Backseta
bulldyke	ublldyke
Catholic	Cathloic
Shitfuck	Shitufck
Blackman	Blackmna
Backdoor	Bcakdoor
assholes	assholse
thirdleg	htirdleg
Syphilis	Syphiils
Poontang	Poonatng
buttplug	buttlpug
manpaste	amnpaste
cameltoe	camelteo
Niggling	Niggilng
slutting	sltuting
arsehole	arseohle
bitching	bicthing
stringer	srtinger
dickweed	dikcweed
peepshow	peepsohw
redlight	reldight
limpdick	limpdikc
Buttface	Buttface
Peepshpw	ePepshpw
fuckable	fukcable
Cuntlick	Cnutlick
fastfuck	fastfcuk
feltcher	fletcher
Molestor	Moelstor
copulate	ocpulate
Eatballs	Etaballs
fistfuck	fisftuck
Stroking	Storking
Freefuck	Freefukc
Israel's	Isarel's
peepshpw	peepshwp
italiano	itlaiano
Meatrack	Meatarck
Cybersex	Cybresex
horniest	hroniest
shitting	shititng
catholic	ctaholic
dickhead	dcikhead
poverty	poveryt
cumshot	cumhsot
colored	coloerd
bitchez	bithcez
Lesbain	Lesabin
Reestie	Resetie
lesbian	lesbain
drunken	druknen
pooping	poopnig
Bombing	Bombnig
hotdamn	hodtamn
negro's	nergo's
Lucifer	Luicfer
Bastard	Basatrd
Lovegoo	Loveogo
Suicide	Siucide
dumbass	dumbass
fagging	fagigng
jiggabo	jiggbao
sexfarm	sexfamr
Mulatto	Mulatot
niggard	inggard
Peehole	Peeohle
Genital	Genitla
Shitter	Shtiter
Bitcher	iBtcher
Funfuck	Funufck
lucifer	lucfier
japcrap	japcarp
Pissing	iPssing
liberal	libreal
Urinary	Uirnary
juggalo	jgugalo
welfare	weflare
Liberal	Liebral
Torture	Tortrue
Whigger	Wihgger
Pindick	Pindcik
Quashie	Quasihe
quashie	quasihe
Phuking	Phuikng
asshole	asshloe
Quickie	Qiuckie
bastard	bastrad
Felatio	Fealtio
Wetback	eWtback
snigger	singger
Sheeney	Sheenye
urinary	urniary
Hotdamn	Hotdanm
Felcher	Felchre
Dipshit	Dpishit
negroes	negores
titfuck	ittfuck
whigger	hwigger
Bollock	Bollokc
Servant	eSrvant
Fuckers	uFckers
Amateur	Aamteur
Swallow	Sawllow
Jerkoff	Jerokff
Welcher	Welhcer
Cumming	Cmuming
Pissoff	Pissoff
killing	killing
pussies	pusseis
fuckbag	fcukbag
servant	sevrant
Fairies	Fiaries
assault	assalut
Pansies	Panises
pissing	pissing
Bumfuck	Bufmuck
Assault	sAsault
niggers	inggers
Dickman	Dikcman
Puddboy	Pudbdoy
baptist	baptsit
Cumquat	Cmuquat
lesbayn	lsebayn
Buggery	Bgugery
jackass	jacakss
Analsex	Aanlsex
Panties	Patnies
Twinkie	Twnikie
urinate	urniate
Radical	Radiacl
Rimming	Rmiming
skumbag	skubmag
Disease	Disaese
negroid	ngeroid
Bondage	oBndage
bumfuck	bufmuck
Vaginal	aVginal
carruth	carruht
analsex	anlasex
Shitcan	Shtican
mulatto	mulatot
swallow	swlalow
rearend	rearned
Shitola	Sihtola
Goddamn	Goddman
remains	remaisn
Refugee	Refugee
Lactate	Lcatate
Kumming	Kummign
Jigaboo	iJgaboo
lovegun	loevgun
rimming	rimmign
Colored	Colroed
Shiting	Shiitng
Crapper	Crpaper
dickwad	dcikwad
niggles	niglges
Redneck	Redenck
goddamn	goddanm
asshore	sashore
tarbaby	atrbaby
buggery	buggrey
whacker	whacekr
Bitchez	Btichez
Triplex	Tripelx
Fuckbag	Fucbkag
strapon	strpaon
niggled	ngigled
amateur	aamteur
shitted	shitetd
gangsta	gangtsa
Baptist	Bapitst
muncher	umncher
Fuckina	uFckina
Shaggin	Shagign
triplex	tripelx
Jiggabo	Jigagbo
honkers	honkres
cocaine	cocanie
Beatoff	Beatfof
Russkie	Russkie
dipshit	disphit
Asslick	Asslick
badfuck	bafduck
Farting	Faritng
mexican	mexcian
Coondog	Coondgo
genital	egnital
torture	totrure
Fisting	Fistnig
russkie	rsuskie
disease	dsiease
suicide	suiicde
bollick	bollcik
lesbain	lesabin
Fuckyou	Fukcyou
Wetspot	Wetspto
shitfit	shtifit
Clogwog	Clogwgo
bitchin	ibtchin
Trannie	Tranine
boobies	booibes
Mexican	Meixcan
kumming	kumimng
puddboy	upddboy
kumquat	kumuqat
barface	barfcae
Juggalo	Juggaol
israeli	isralei
Barface	Bafrace
Nastyho	Natsyho
Penises	ePnises
reestie	reestei
phukked	hpukked
Spitter	Sptiter
pansies	apnsies
Cocaine	Ccoaine
Illegal	Illgeal
Vatican	Vatiacn
Honkers	Hnokers
Execute	Exceute
asswipe	saswipe
slapper	slpaper
Suckoff	uSckoff
clogwog	clowgog
Asshore	Ashsore
fuckers	fucekrs
Shinola	Shinloa
Hooters	oHoters
Negroes	Negrose
quickie	quikcie
Sextoys	Sexotys
Fagging	Faggnig
penises	pensies
Urinate	Urintae
lowlife	lowilfe
Israeli	Isralei
Cumshot	Cumhsot
Strapon	Starpon
welcher	welchre
Niggles	Niglges
kissass	kissass
Drunken	Drunkne
shiting	hsiting
Lovegun	Lovgeun
Lubejob	Lubejbo
Titties	Titties
Fuckoff	Fuckfof
titties	titites
Gangsta	Gangsat
wanking	wnaking
phuking	hpuking
bondage	bnodage
bigbutt	bigbtut
fuckyou	fucykou
Lesbian	Lesiban
shinola	shniola
bitcher	ibtcher
handjob	hnadjob
doo-doo	do-odoo
funeral	ufneral
Orgasim	Orgsaim
Fatfuck	Fatfcuk
sextogo	esxtogo
Snigger	Snigger
Blowjob	Blojwob
Wanking	aWnking
pindick	pindcik
Kumquat	Kumqaut
Hiscock	Hisccok
Welfare	Welfaer
Bitchin	Bithcin
Funeral	Fuenral
Brothel	Brotehl
brothel	borthel
Carruth	Carrtuh
bollock	bollock
Addicts	Addicst
Jackoff	Jacokff
orgasim	orgasmi
Tarbaby	Tarbbay
assfuck	assufck
jigaboo	jigaobo
hosejob	hoseojb
Niggard	Niggard
Buttman	uBttman
Rearend	Reaernd
Hosejob	oHsejob
playboy	plabyoy
mideast	miedast
puntang	puntnag
phungky	puhngky
Deposit	Deopsit
Skumbag	Skumabg
bitches	ibtches
Schlong	Scholng
Bestial	Bsetial
Hookers	Hooekrs
Remains	Remians
shaggin	shaggni
spitter	spitetr
livesex	livesxe
Muncher	uMncher
Livesex	iLvesex
Whiskey	Wihskey
scrotum	srcotum
jimfish	jifmish
Aroused	Aruosed
Jimfish	Jimfsih
asslick	asslikc
Lesbayn	eLsbayn
Ecstacy	Esctacy
Pussies	Pussise
Pooping	Poopign
ecstacy	ecsatcy
Lowlife	Lowlief
trannie	trnanie
women's	womens'
Jackass	Jackass
Pee-pee	Pee-pee
vatican	vtaican
Slapper	Slappre
asskiss	saskiss
Niggers	Nigegrs
Asshole	Asshloe
Fuckher	uFckher
Puntang	uPntang
fairies	faiires
cumming	cmuming
addicts	dadicts
cumquat	cumuqat
Kissass	Ksisass
whiskey	hwiskey
jackoff	jakcoff
Hostage	Hosatge
illegal	illegal
fucking	fucknig
hostage	hsotage
shitter	sihtter
cumfest	cmufest
Whacker	Whcaker
crapper	crappre
Boobies	Boobies
sheeney	seheney
pissoff	ipssoff
schlong	cshlong
bombing	bmobing
fuckina	ufckina
chinese	chniese
Cumfest	Cufmest
fuckoff	fucokff
getiton	egtiton
Niggled	Niggeld
waysted	waysetd
Mideast	Midesat
hooters	hootesr
lovegoo	loveogo
bestial	bsetial
Banging	Bagning
Phukked	Phukekd
Cocknob	Cocnkob
Dumbass	Dumbass
bombers	bomebrs
Handjob	Handjbo
Women's	Wmoen's
Raghead	Ragheda
hustler	uhstler
Waysted	Waysetd
bazooms	baozoms
dickman	dicmkan
Titfuck	Titfcuk
Badfuck	Badfukc
sextoys	sextyos
raghead	ragehad
Bazooms	Bazooms
Bollick	Bollcik
Playboy	Plabyoy
wetspot	westpot
vaginal	vaginla
twinkie	wtinkie
Sexfarm	eSxfarm
Shitfit	Shitift
coondog	coondgo
Phungky	hPungky
African	fArican
hookers	hookesr
blowjob	lbowjob
Negro's	Negr'os
felatio	felaito
nastyho	nastyoh
deposit	depsoit
Bombers	Bombres
panties	apnties
fatfuck	ftafuck
felcher	eflcher
aroused	raoused
Asskiss	Assikss
Shitted	hSitted
Negroid	Nergoid
Chinese	hCinese
redneck	erdneck
Scrotum	Srcotum
fuckher	fuchker
Bitches	Bithces
Getiton	Geitton
funfuck	fufnuck
upskirt	upsikrt
jerkoff	jerkfof
Destroy	Destryo
Fucking	Fucknig
shitola	shiotla
fisting	ifsting
Killing	Killnig
refugee	refuege
lactate	lactaet
beatoff	betaoff
shitcan	hsitcan
Poverty	oPverty
failure	failrue
Bigbutt	Bgibutt
lubejob	luebjob
Fuckpig	Fucpkig
suckoff	suckfof
pee-pee	pee-pee
execute	execuet
wetback	ewtback
african	africna
Asswipe	Asswpie
Hustler	uHstler
farting	fatring
radical	rdaical
peehole	peehoel
destroy	dsetroy
cocknob	cockonb
flasher	flasehr
Japcrap	Japcrpa
buttman	buttamn
Failure	Failrue
Dickwad	Dikcwad
crapola	rcapola
hiscock	ihscock
banging	bangnig
Doo-doo	Dood-oo
Crapola	Carpola
Assfuck	Asfsuck
Flasher	Flahser
Sextogo	Sexotgo
fuckpig	fuckpgi
Upskirt	Upskitr
Areola	Aerola
Racial	Racila
escort	ecsort
pistol	pisotl
Tortur	Torutr
nookie	nooike
Gyppie	Gyppei
krappy	krpapy
Babies	Bbaies
robber	robber
Africa	Afriac
Nooner	Nooner
Incest	Inecst
nudger	nudgre
fuckit	fuckti
chinky	chikny
Failed	Failde
Tittie	Tittie
Slopey	Solpey
Kanake	Kaanke
Iblowu	Ilbowu
Gringo	rGingo
pommie	opmmie
Pooper	Poopre
Hummer	Humemr
Tantra	Tantar
moslem	molsem
firing	fiirng
shited	sihted
retard	retrad
kondum	konudm
Noonan	Noonan
dammit	dammit
Toilet	Toliet
mockie	omckie
rectum	rectmu
weapon	wepaon
Zigabo	Zigbao
pisser	pisesr
pecker	pceker
Tosser	oTsser
feltch	fetlch
Escort	Escotr
niggor	ngigor
Nudger	Nudgre
sniper	snipre
Darkie	Darkei
kigger	kgiger
period	peirod
Kigger	Kigegr
gringo	grigno
killed	kliled
nittit	nittti
Swalow	Sawlow
Wanker	Wakner
tortur	totrur
darkie	darike
Weenie	Weneie
Farted	Faretd
Fister	Fistre
soviet	soveit
spunky	spukny
hitler	hilter
suckme	sukcme
dahmer	adhmer
Sucker	Scuker
Rapist	Rpaist
turnon	tunron
Hijack	Hiajck
gummer	gummre
bigger	bigegr
hooker	hooekr
Pudboy	uPdboy
skanky	skanyk
Jizzum	Jizzum
Dahmer	Damher
stiffy	sitffy
Mormon	Mromon
crappy	rcappy
Pimped	Pimpde
Wigger	Wigegr
horney	ohrney
Tampon	Tmapon
flydye	flyyde
reefer	reefer
Orgasm	Oragsm
Turnon	Trunon
Slutty	Slutty
diddle	idddle
Feltch	eFltch
willie	wlilie
creamy	craemy
liquor	liquro
Israel	sIrael
whitey	whtiey
honger	hnoger
Titjob	Titojb
niggur	ngigur
Rectum	Rectmu
Nignog	Ningog
Attack	tAtack
faggot	fagogt
wanker	wanekr
Commie	Commei
Stroke	Stroek
Christ	Crhist
Period	ePriod
Condom	Cnodom
Liquor	Liqour
Addict	Additc
sexpot	sepxot
Hodgie	Hogdie
bugger	ubgger
Vagina	aVgina
Reefer	Refeer
slutty	slutyt
Creamy	Cremay
popimp	oppimp
Looser	Losoer
coitus	ciotus
titjob	tijtob
Hooker	Hookre
Chinky	Cihnky
breast	rbeast
Sexpot	Sxepot
Nookie	Nookei
Phuked	Puhked
insest	inesst
orgasm	orgsam
Krappy	Krpapy
pisses	pisses
Tranny	rTanny
faeces	afeces
yankee	ynakee
Molest	Molets
farted	afrted
sucker	scuker
beaver	ebaver
Racist	Racits
Assman	sAsman
virgin	virgni
Asshat	Assaht
Geezer	eGezer
tosser	tosser
jigger	jigger
kaffir	kaffir
Orgies	Orgise
Cacker	Cacekr
herpes	hepres
iblowu	ilbowu
biatch	biacth
Pissed	Pissed
blacks	blcaks
Mockie	Mocike
Lotion	Lotoin
pissed	pissed
toilet	toilte
Killed	Killde
Hitler	Hitelr
Nigger	iNgger
dyefly	dyfely
polack	ploack
reject	rejetc
Kaffre	Kfafre
looser	loosre
Niggle	Niglge
hummer	hummer
sextoy	esxtoy
Tinkle	Tiknle
fckcum	cfkcum
Dyefly	Dyfely
Fuckin	uFckin
Licker	Likcer
Gaysex	Gayesx
Fondle	Fonlde
cacker	ccaker
Uterus	Uteurs
racist	racsit
killer	ikller
Damnit	Damint
Sexual	Sxeual
weenie	weenei
pimped	ipmped
Fungus	uFngus
Fuckme	Fcukme
noonan	ononan
German	Gemran
Nookey	Nooeky
terror	terrro
kanake	kanaek
Fucked	Fucekd
fuckin	ufckin
Niggur	Niggur
tinkle	tinkel
Sniper	Sinper
nooner	nooner
honkey	hokney
Ethnic	Ethnci
Pisses	iPsses
Diddle	Didlde
molest	moelst
byatch	baytch
nipple	niplpe
sexing	sexnig
Bugger	Bguger
Reject	Rejetc
fucked	ufcked
Weewee	eWewee
Coitus	Coiuts
Fetish	Fetihs
lotion	lotoin
fatass	ftaass
Flange	Flagne
tittie	tittei
Pissin	Psisin
Robber	Rbober
doodoo	doodoo
Willie	Wlilie
babies	babeis
pimper	ipmper
stupid	stupdi
jizzim	jzizim
licker	ilcker
Pistol	Pisotl
Pisser	iPsser
commie	commei
attack	attakc
hindoo	ihndoo
Ribbed	iRbbed
Gummer	Gumemr
Rimjob	Rimjbo
Hardon	Hardno
Polack	oPlack
Boonie	Booine
Retard	eRtard
Stiffy	Stfify
sodomy	osdomy
flange	flaneg
Niggah	Nigagh
lesbin	lebsin
Niglet	Nilget
zigabo	zigaob
Fatass	Fatass
biteme	bietme
Libido	iLbido
Macaca	Macaac
nlggor	nlgogr
Boonga	oBonga
hardon	hardno
gaysex	gayesx
addict	additc
muslim	muslmi
Niggaz	Niggza
Lolita	Loltia
Cunntt	Cuntnt
cummer	ucmmer
fuckme	fukcme
coolie	coolie
Murder	Mudrer
hijack	hijcak
Weapon	Weapno
kummer	kumemr
Heroin	Heorin
desire	deisre
Nlgger	Nglger
Crappy	rCappy
Spooge	Spogoe
rapist	rapsit
Virgin	Virgni
areola	aroela
libido	libdio
Desire	eDsire
Spunky	Spnuky
Bitchy	Btichy
fucker	fcuker
kaffre	kfafre
Snatch	Santch
swalow	swlaow
Nlggor	Nlgogr
kaffer	akffer
Suckme	Scukme
tantra	tantar
Faggot	Faggto
tampon	atmpon
wigger	iwgger
Beaner	Baener
Bigass	Bgiass
Harder	Hardre
Honkey	Honeky
russki	russki
Pecker	Peckre
condom	ocndom
christ	hcrist
Beaver	Beavre
Crotch	Crtoch
Pimper	Pimpre
Biatch	Biacth
pussie	upssie
Breast	rBeast
boonga	boogna
Cancer	aCncer
Pussie	Pussie
Mockey	Mokcey
Killer	iKller
Jigger	Jiggre
lickme	lickem
Whites	Wihtes
german	gemran
Horney	Horeny
israel	isarel
Muslim	Msulim
ethnic	etnhic
Hindoo	Hinodo
Fucker	Fuckre
snatch	snacth
racial	racail
buried	bruied
brea5t	breat5
Doodoo	Doodoo
Niggor	iNggor
mormon	mormno
Faeces	Faecse
tranny	trnany
Lesbin	Lebsin
bohunk	bohukn
Yankee	Yankee
Wuzzie	Wuzzei
vagina	vagnia
Shited	Sihted
nignog	nigong
Fckcum	Fcckum
lolita	loliat
nigger	ingger
niglet	niglte
Insest	nIsest
Cummer	Cummer
church	chucrh
Flydye	Flyyde
asshat	assaht
Trojan	Torjan
Sexing	Sexign
crimes	criems
Russki	Russik
mockey	mcokey
crotch	cortch
Blacks	Blakcs
Herpes	eHrpes
Honger	Hogner
Fuckit	Fuckti
hodgie	hodgei
Sodomy	Sodoym
Nittit	Nititt
heroin	heroni
Church	hCurch
Buried	Buride
Shitty	Sihtty
fungus	fungsu
wuzzie	wuzzie
rigger	rigger
Coolie	Cooile
damnit	admnit
Kaffir	aKffir
orgies	ogries
Penile	ePnile
rimjob	rmijob
trojan	rtojan
penile	epnile
Kaffer	Kaffre
shitty	sihtty
Whitey	hWitey
fister	fsiter
Popimp	Poipmp
Stupid	Sutpid
phuked	phukde
jizzum	ijzzum
niggle	niggle
sexual	esxual
macaca	amcaca
Firing	Firign
beaner	benaer
jewish	jewsih
Sextoy	Setxoy
ribbed	ribbed
geezer	geezer
tongue	tognue
murder	mudrer
boonie	booine
Lickme	Lcikme
Tongue	oTngue
Kummer	Kummre
Jewish	Jweish
Flydie	Flyide
nookey	nookye
niggah	niggha
incest	incets
whites	wihtes
Nipple	Nipple
africa	arfica
Moslem	Msolem
Kondum	oKndum
Terror	Terror
bigass	bigsas
weewee	weeewe
Soviet	Soveit
niggaz	ngigaz
failed	fialed
Pommie	oPmmie
Crimes	Cirmes
nlgger	nlggre
Biteme	Biteem
fetish	fteish
Bigger	Bgiger
uterus	tuerus
slopey	lsopey
Dammit	aDmmit
Rigger	Riggre
cancer	cnacer
Skanky	Sknaky
Brea5t	Breat5
Byatch	Bytach
spooge	sopoge
pissin	psisin
cunntt	cuntnt
pooper	popoer
Bohunk	Bouhnk
assman	asmsan
pudboy	updboy
gyppie	gpypie
bitchy	bicthy
Jizzim	Jzizim
fondle	ofndle
harder	haredr
stroke	storke
flydie	lfydie
bogan	bgoan
booby	oboby
darky	dakry
Taboo	Tbaoo
loser	lsoer
Moron	Moorn
kills	iklls
Moles	Molse
Devil	Deivl
hoser	hosre
Pixie	Pixei
faith	afith
enemy	neemy
Lynch	Lynhc
Roach	Roahc
Piker	Pikre
Forni	Fonri
bible	bilbe
negro	nergo
balls	blals
ginzo	gizno
Smack	Smcak
sooty	sooyt
Titty	Ttity
Porno	oPrno
Vulva	Vulav
fatah	aftah
urine	urien
cooly	coloy
Dildo	Dlido
Teste	Tsete
Slave	lSave
fucks	fcuks
Crabs	Carbs
Rabbi	Rbabi
fight	fgiht
Loser	Loesr
Negro	Ngero
pixie	piixe
Fraud	rFaud
Boobs	Bobos
Girls	iGrls
Boody	Booyd
Fubar	Fbuar
Chode	Cohde
Fight	Fihgt
moron	omron
fraud	fradu
Pocho	oPcho
lezbo	elzbo
Honky	Hnoky
gross	gorss
Idiot	Iidot
boang	boagn
beast	ebast
sexed	sxeed
Sandm	Sanmd
choad	cohad
kotex	koetx
shits	hsits
panti	panit
Semen	Semne
shite	shiet
screw	srcew
Death	eDath
Asian	Aisan
Pikey	Pikye
sandm	snadm
fucck	fcuck
Angie	Agnie
pu55y	pu55y
crash	rcash
Whash	Wahsh
trots	torts
niger	inger
black	balck
slopy	slpoy
fagot	faogt
naked	nkaed
Raped	Raepd
taboo	tbaoo
bombs	bobms
Gyppo	Gypop
feces	feecs
whash	whahs
Boang	Baong
Color	oClor
usama	suama
Latin	Latni
Ginzo	Gnizo
Hymie	Hymei
mgger	mgegr
Harem	Hraem
Kafir	Kafri
Whore	Wohre
Kraut	Karut
shhit	hshit
lezzo	lezzo
Drunk	Durnk
Naked	Naekd
fugly	ufgly
enema	eneam
Hamas	Hmaas
Slant	Slatn
abuse	aubse
Spank	Sapnk
goyim	gyoim
slutt	slutt
Hoser	Hoesr
Spunk	pSunk
cra5h	car5h
sissy	isssy
hamas	ahmas
Lesbo	eLsbo
lynch	ylnch
Sodom	Sdoom
Slutt	lSutt
hussy	hussy
Necro	Ncero
Nymph	Nmyph
Sperm	Spemr
raped	rapde
Shits	hSits
Cohee	Choee
Fugly	Fulgy
boody	obody
Husky	Husyk
boobs	boosb
Fuuck	uFuck
mggor	mggro
Angry	Angyr
Fairy	Fiary
Usama	sUama
piker	pkier
Nigga	Nigga
Goyim	oGyim
chode	choed
Raper	Raepr
Vomit	Voimt
pocho	pohco
Shite	Shiet
stagg	tsagg
Willy	Wilyl
gubba	ugbba
Lugan	uLgan
mafia	mfaia
slave	lsave
pansy	apnsy
Spick	pSick
Cooly	Cooyl
dirty	idrty
Pussy	Pusys
semen	seemn
pendy	penyd
Stagg	Stagg
lezbe	elzbe
Fucck	Fucck
Pubic	Pbuic
queef	qeuef
Lezbo	eLzbo
Pendy	ePndy
Felch	Flech
Penis	Pensi
Eatme	Eamte
Sadis	aSdis
Horny	oHrny
husky	husyk
Enemy	Eenmy
spick	psick
Sadom	aSdom
girls	grils
Crash	Crsah
harem	haerm
Arabs	rAabs
fatso	fatos
Screw	Scrwe
Gyppy	Gpypy
Lezbe	Lzebe
jebus	jeubs
Jizim	Jiizm
Booty	oBoty
jiggy	ijggy
Urine	rUine
Fatso	Ftaso
jesus	jseus
Boong	Boong
Abuse	Abues
Fucka	Fucak
jigga	jigag
Farty	Fraty
Mocky	oMcky
nigga	nigga
willy	wlily
Queef	Quefe
osama	osmaa
sodom	osdom
horny	ohrny
Seppo	Seppo
arabs	raabs
Kills	Klils
tramp	tarmp
raper	raepr
Feces	Feecs
twink	tiwnk
pommy	opmmy
Nasty	Natsy
spunk	psunk
vulva	vulav
spank	psank
Queer	Qeuer
Beast	Baest
Randy	Ranyd
squaw	qsuaw
Choad	hCoad
boner	obner
asian	aisan
hymie	hyime
penis	pensi
Jigga	Jgiga
fucka	fcuka
Sissy	Sissy
Allah	Alalh
bitch	bicth
Fucks	Fukcs
Fatah	Faath
Tramp	Trmap
color	oclor
kinky	kikny
Hymen	yHmen
Black	Blakc
Fagot	Fgaot
kafir	kfair
adult	adlut
Nigre	Ngire
skank	skakn
angie	agnie
Pu55i	P5u5i
lugan	lguan
Slopy	Sloyp
Bogan	Bogna
Mggor	gMgor
Pu55y	P5u5y
crime	criem
Knife	Knief
felch	flech
drunk	drnuk
cocky	cokcy
smack	msack
demon	dmeon
seppo	esppo
Kinky	Kikny
kraut	karut
sadis	sadsi
Cra5h	Crah5
sadom	sadmo
allah	lalah
Trots	Trost
fubar	fbuar
peni5	pnei5
pu55i	pu5i5
whore	whoer
Peni5	Pen5i
Bombs	Bomsb
Lezzo	Lezoz
teste	teset
roach	raoch
joint	ojint
eatme	eatem
Bunga	Bugna
dildo	idldo
hymen	hymne
Shoot	hSoot
angry	anrgy
Sluts	Sltus
Pommy	oPmmy
farty	afrty
fuuck	fucuk
death	daeth
vomit	voimt
Shhit	Shhti
argie	agrie
Twink	Tiwnk
Panti	Pnati
jizim	jiizm
pikey	pikye
Cocky	Cocyk
Sexed	Sxeed
slime	slmie
Nigra	Nirga
Booby	Booyb
Joint	oJint
nigra	nirga
crabs	rcabs
crack	crcak
porno	ponro
Argie	Arige
knife	knfie
Chink	Chnik
Blind	Blidn
Crack	Crcak
Kotex	Koetx
Crime	Criem
Squaw	Suqaw
Prick	rPick
pocha	opcha
nasty	nsaty
nigre	ngire
gyppy	ygppy
Erect	rEect
Jebus	Jeubs
Demon	Dmeon
queer	qeuer
Niger	Ngier
bunga	bunag
pussy	psusy
randy	ranyd
Enema	nEema
Gross	rGoss
Limey	Lmiey
fairy	fariy
Balls	Balls
rabbi	arbbi
honky	hnoky
Jiggy	Jgigy
forni	froni
slant	lsant
boong	boong
Asses	Asses
Bible	iBble
Mafia	Mafai
mocky	omcky
moles	moels
Jesus	Jseus
Dirty	Ditry
asses	asses
limey	lmiey
Gubba	Gubba
Darky	Draky
Pocha	Pohca
prick	rpick
idiot	idoit
Bitch	iBtch
erect	ercet
jihad	jhiad
Hussy	Hussy
Faith	Faiht
titty	ittty
Satan	Staan
devil	deivl
blind	bilnd
necro	nerco
Slime	Silme
Osama	Oasma
satan	satna
booty	booty
pubic	upbic
Adult	Adlut
sluts	sults
cohee	ochee
gyppo	gyppo
latin	laitn
Boner	Boenr
Jihad	Jhiad
Pansy	aPnsy
Skank	Sknak
Mgger	Mggre
Sooty	Sooty
shoot	shoto
sperm	sprem
nymph	nymhp
lesbo	lebso
chink	cihnk
ikey	kiey
jigg	ijgg
bomd	obmd
Hell	eHll
Paki	Paik
Skum	Sukm
Nook	oNok
Anal	Anla
dope	odpe
Rere	Rree
Hoes	Hose
turd	utrd
Fore	oFre
meth	meht
fuck	ufck
scum	sucm
Piky	Piyk
whiz	wihz
Piss	iPss
tard	atrd
bast	bsat
cunt	ucnt
nazi	nzai
mams	masm
Hole	oHle
Pimp	iPmp
Nuke	Nkue
Cock	oCck
Babe	aBbe
Slut	Sult
Fear	eFar
abbo	abbo
spig	sipg
pimp	ipmp
jism	jsim
rere	rree
kunt	kutn
scag	sacg
slav	lsav
hork	hrok
orga	roga
Wank	aWnk
Pube	uPbe
laid	ladi
Pric	rPic
Arab	rAab
Kink	Kikn
peck	epck
Mofo	oMfo
Pixy	Piyx
cock	ccok
Floo	Folo
dong	dnog
skum	ksum
Jizm	Jimz
groe	greo
muff	muff
pohm	phom
krap	karp
Jism	Jsim
shav	hsav
Spig	Spgi
Koon	oKon
Dead	Daed
Pi55	Pi55
Cunt	uCnt
Lies	Lise
chav	cahv
Moky	oMky
boom	bomo
jiga	jgia
Dike	Diek
Sexy	Seyx
Gypo	yGpo
Nazi	Naiz
Butt	Butt
gypo	ygpo
pixy	ipxy
Doom	Domo
cumm	cumm
teat	etat
blow	blwo
hore	hroe
heeb	heeb
jugs	jusg
phuq	hpuq
cigs	cgis
Hore	Hroe
Bong	Bogn
hebe	ehbe
phuk	puhk
Arse	Asre
snot	snto
butt	btut
alla	alal
pric	pirc
Porn	Pron
jizm	jimz
Drug	Durg
oral	orla
Poop	Popo
Tard	Trad
Burn	uBrn
Died	Deid
piss	piss
Perv	Prev
Fire	Fier
poon	pono
doom	odom
Jade	Jdae
Jigg	Jigg
Kill	Kill
Pros	rPos
Poon	Poon
Blow	lBow
damn	dman
dago	daog
kums	ukms
vibr	vbir
Puss	Psus
Shat	Saht
Crap	Carp
Tits	Ttis
Clit	Cilt
shag	shga
hell	hell
bomb	obmb
dumb	udmb
Munt	uMnt
tits	tist
Wetb	eWtb
fear	fera
nude	nued
jizz	ijzz
anus	ansu
Meth	Meht
Gook	oGok
Dink	iDnk
boob	boob
spik	psik
Geez	Geez
Lezz	eLzz
Honk	Hokn
kike	ikke
Dyke	Dyek
Taff	aTff
nook	noko
Phuq	hPuq
kill	kill
Scat	Scta
Dago	aDgo
slut	lsut
milf	mlif
Shav	Sahv
Hebe	Heeb
whop	hwop
spic	psic
wetb	webt
Slav	Slva
porn	ponr
scat	scta
Homo	Hoom
drug	drgu
Whiz	hWiz
Dive	iDve
dego	dgeo
barf	abrf
payo	pyao
lies	leis
Horn	Honr
Shag	Shga
Hapa	Haap
Jeez	eJez
pi55	pi55
puss	puss
Spit	pSit
Cigs	Cisg
whit	hwit
ra8s	ar8s
Jizz	Jizz
perv	eprv
died	dide
Spik	pSik
Pusy	Psuy
honk	ohnk
Groe	Gore
rump	rmup
shit	hsit
Krap	Krpa
Limy	iLmy
nigr	nirg
Oral	rOal
dyke	ydke
dead	deda
Hobo	Hoob
Chav	Chva
Boom	Boom
Shit	hSit
Kock	Kokc
fart	frat
Dick	Dikc
poop	opop
Dumb	uDmb
geni	gein
hoes	heos
mofo	omfo
Whit	hWit
pube	pbue
Kyke	Kyek
fuks	fkus
dick	idck
orgy	oryg
Nigg	iNgg
burn	ubrn
Kums	uKms
spit	psit
anal	aanl
hole	hloe
twat	twta
piky	piyk
Suck	uSck
Tang	Tnag
Heeb	Hebe
taff	taff
arab	arba
tang	tnag
Nude	uNde
babe	abbe
nuke	unke
Vibr	iVbr
wuss	wuss
Dies	Deis
pusy	puys
fore	foer
moky	moyk
Dong	Dnog
Smut	Smtu
Nigr	iNgr
cunn	ucnn
Coon	oCon
gypp	gpyp
kink	kikn
Laid	aLid
jeez	jeze
sick	scik
koon	kono
puke	puek
arse	rase
Sick	iSck
Payo	Pyao
Milf	Mifl
hobo	hoob
Pudd	Pudd
Itch	Ithc
Cumm	Cmum
Scag	Scga
Dego	Dgeo
Kike	Kkie
suck	usck
horn	hron
Orgy	rOgy
pros	prso
lezz	lzez
Anus	Auns
Dope	Doep
munt	umnt
Barf	aBrf
Cunn	Cunn
Fart	aFrt
Twat	Twta
Ikey	kIey
Whop	Whpo
Jugs	Jgus
Turd	Tudr
Jiga	Jgia
Peck	ePck
hapa	ahpa
Phuk	Puhk
Gipp	Gpip
Puke	Pkue
Ra8s	Ras8
paki	pkai
dies	deis
limy	ilmy
deth	dteh
Muff	uMff
Quim	Qumi
Hook	oHok
Bomb	oBmb
Wuss	Wuss
Scum	Sucm
Chin	Chni
Spic	Sipc
Boob	Boob
fire	frie
hook	hook
dike	idke
kock	kcok
nigg	nigg
coon	cono
sexy	sxey
Rump	Rmup
Fuck	uFck
clit	lcit
Fuks	Fkus
dink	dikn
shat	shta
kyke	kyek
smut	sumt
floo	folo
Deth	eDth
chin	hcin
Orga	Ogra
Abbo	Abbo
pudd	pdud
itch	icth
Rape	Rpae
jade	jaed
gook	goko
Bomd	Bodm
Damn	Danm
Alla	Alal
Snot	Sont
wank	wakn
Bast	aBst
rape	raep
homo	ohmo
crap	rcap
quim	qumi
Pohm	Pomh
Kunt	Knut
bong	bnog
dive	idve
Teat	Teta
Hork	oHrk
Geni	Gein
Mams	aMms
geez	geze
gipp	igpp
Gypp	Gypp
jew	jwe
Uck	Ukc
jiz	ijz
gob	gbo
Pud	Pdu
sob	osb
God	Gdo
sex	esx
Ass	Ass
pot	opt
Xxx	Xxx
Poo	oPo
dix	idx
nip	npi
Wog	oWg
kkk	kkk
nig	ngi
Goy	Gyo
gin	ign
poo	poo
Sob	Sbo
Fuc	uFc
Xtc	tXc
wop	owp
Gay	aGy
pee	pee
Dix	iDx
Jew	eJw
wab	awb
Mad	Mda
pud	upd
ero	eor
Sex	eSx
fat	fta
hiv	hvi
Evl	Elv
jap	ajp
tnt	ntt
Tit	iTt
gun	gnu
wtf	twf
Pom	oPm
Lez	Lze
Gob	oGb
goy	gyo
Fuk	Fku
uck	cuk
Fat	Fta
bra	rba
Tnt	nTt
cum	cmu
wog	wgo
ass	ass
Kkk	kKk
Pee	ePe
Jap	Jpa
Abo	Aob
Cum	uCm
Nip	Npi
sos	sso
pom	opm
xtc	txc
tit	itt
Gyp	Gpy
fuk	fku
evl	elv
xxx	xxx
Gun	Gnu
Kid	iKd
fok	fko
mad	amd
Sos	oSs
Fok	oFk
Gin	iGn
kum	kmu
Fag	aFg
Wab	Wba
abo	bao
die	ide
kid	kdi
gyp	gpy
Hiv	Hvi
lsd	lds
gay	agy
god	gdo
Nig	Ngi
Bra	Bar
Jiz	iJz
Pot	Pto
Wop	Wpo
Kum	Kmu
Lsd	sLd
lez	lze
fag	afg
Wtf	tWf
fuc	fcu
Ero	Eor
Die	Dei
uk	ku
wn	nw
ho	oh
ky	yk
Wn	nW
Uk	kU
fu	uf
Ky	yK
bi	ib
Bi	iB
Ho	oH
Fu	uF
